가다	가	가니
가까워지다	가까워지어	가까워져	가까워지니
가깝다	가까워	가까우니
가꾸다	가꾸어(가꿔)	가꾸니
가누다	가누어(가눠)	가누니
가늘어지다	가늘어지어(가늘어져)	가늘어지니
가두다	가두어(가둬)	가두니
가득차다	가득차	가득차니
가라앉히다	가라앉히어(가라앉혀)	가라앉히니
가려내다	가려내어(가려내)	가려내니
가려보다	가려보아(가려봐)	가려보니
가려지다	가려지어(가려져)	가려지니
가려지다	가려지어(가려져)	가려지니
가로걸리다	가로걸리어(가로걸려)	가로걸리니
가로놓이다	가로놓이어(가로놓여)	가로놓이니
가로눕다	가로누워	가로누우니	가로눕는
가로눕히다	가로눕히어(가로눕혀)	가로눕히니
가로막히다	가로막히어(가로막혀)	가로막히니
가로젓다	가로저어	가로저으니	가로젓는
가로지르다	가로질러	가로지르니
가로질리다	가로질리어(가로질려)	가로질리니
가로채다	가로채어(가로채)	가로채니
가르다	갈라	가르니
가르랑거리다	가르랑거리어(가르랑거려)	가르랑거리니
가르치다	가르치어(가르쳐)	가르치니
가리다	가리어(가려)	가리니
가리다	가리어(가려)	가리니
가리다	가리어(가려)	가리니
가리다	가리어(가려)	가리니
가리어지다	가리어지어(가리어져)	가리어지니
가리키다	가리키어(가리켜)	가리키니
가만두다	가만두어(가만둬)	가만두니
가물다	가물어	가무니	가무오
가물거리다	가물거리어(가물거려)	가물거리니
가벼워지다	가벼워지어(가벼워져)	가벼워지니
가빠지다	가빠지어(가빠져)	가빠지니
가새지르다	가새질러	가새지르니
가시다	가시어(가셔)	가시니
가위눌리다	가위눌리어(가위눌려)	가위눌리니
가져가다	가져가	가져가니
가져다주다	가져다주어(가져다줘)	가져다주니
가져오다	가져와	가져오니
가지다	가지어(가져)	가지니
간지럽히다	간지럽히어(간지럽혀)	간지럽히니
간질거리다	간질거리어(간질거려)	간질거리니
간질이다	간질이어(간질여)	간질이니
간추리다	간추리어(간추려)	간추리니
갇히다	갇히어(갇혀)	갇히니
갈다	갈아	가니	가오
갈다	갈아	가니	가오
갈다	갈아	가니	가오
갈다	갈아	가니	가오
갈겨쓰다	갈겨써	갈겨쓰니
갈구다	갈구어(갈궈)	갈구니
갈기다	갈기어(갈겨)	갈기니
갈라내다	갈라내어(갈라내)	갈라내니
갈라붙이다	갈라붙이어(갈라붙여)	갈라붙이니
갈라서다	갈라서	갈라서니
갈라지다	갈라지어(갈라져)	갈라지니
갈리다	갈리어(갈려)	갈리니
갈리다	갈리어(갈려)	갈리니
갈리다	갈리어	갈려	갈리니
갈마들다	갈마들어	갈마드니	갈마드오
갈서다	갈서	갈서니
갈아끼우다	갈아끼워	갈아끼우니
갈아대다	갈아대어(갈아대)	갈아대니
갈아붙이다	갈아붙이어	갈아붙여	갈아붙이니
갈아붙이다	갈아붙이어(갈아붙여)	갈아붙이니
갈아입히다	갈아입히어(갈아입혀)	갈아입히니
갈아주다	갈아주어(갈아줘)	갈아주니
갈아치우다	갈아치워	갈아치우니
갈아타다	갈아타	갈아타니
감겨들다	감겨들어	감겨드니	감겨드오
감기다	감기어	감겨	감기니
감기다	감기어(감겨)	감기니
감기다	감기어(감겨)	감기니
감기다	감기어(감겨)	감기니
감기다	감기어(감겨)	감기니
감돌다	감돌아	감도니	감도오
감싸다	감싸	감싸니
감싸이다	감싸이어(감싸여)	감싸이니
감아올리다	감아올리어(감아올려)	감아올리니
감아쥐다	감아쥐어	감아쥐니
감잡히다	감잡히어(감잡혀)	감잡히니
감추다	감추어(감춰)	감추니
감치다	감치어(감쳐)	감치니
감치다	감치어(감쳐)	감치니
값나가다	값나가	값나가니
갖다	갖는
갖다붙이다	갖다붙이어	갖다붙여	갖다붙이니
갖다주다	갖다주어	갖다줘	갖다주니
갖추다	갖추어(갖춰)	갖추니
같아지다	같아지어(같아져)	같아지니
개다	개어(개)	개니
개다	개어(개)	개니
개다	개어(개)	개니
개기다	개기어(개겨)	개기니
개키다	개키어(개켜)	개키니
갸우뚱거리다	갸우뚱거리어(갸우뚱거려)	갸우뚱거리니
갸웃거리다	갸웃거리어(갸웃거려)	갸웃거리니
거꾸러뜨리다	거꾸러뜨리어(거꾸러뜨려)	거꾸러뜨리니
거꾸러지다	거꾸러지어(거꾸러져)	거꾸러지니
거느리다	거느리어(거느려)	거느리니
거닐다	거닐어	거니니	거니오
거두다	거두어(거둬)	거두니
거두다	거두어(거둬)	거두니
거두다	거두어(거둬)	거두니
거두어들이다	거두어들이어(거두어들여)	거두어들이니
거둬들이다	거둬들이어(거둬들여)	거둬들이니
거드럭거리다	거드럭거리어(거드럭거려)	거드럭거리니
거들다	거들어	거드니	거드오
거들다	거들어	거드니	거드오
거들떠보다	거들떠보아(거들떠봐)	거들떠보니
거들뜨다	거들떠	거들뜨니
거들먹거리다	거들먹거리어(거들먹거려)	거들먹거리니
거듭나다	거듭나	거듭나니
거듭되다	거듭되어(거듭돼)	거듭되니
거르다	걸러	거르니
거르다	걸러	거르니
거리끼다	거리끼어(거리껴)	거리끼니
거머쥐다	거머쥐어	거머쥐니
거세어지다	거세어지어(거세어져)	거세어지니
거세지다	거세지어(거세져)	거세지니
거스러지다	거스러지어(거스러져)	거스러지니
거스르다	거슬러	거스르니
거스르다	거슬러	거스르니
거스르다	거슬러	거스르니
거슬리다	거슬리어(거슬려)	거슬리니
거우다	거우어(거워)	거우니
거쳐가다	거쳐가	거쳐가니
거치다	거치어(거쳐)	거치니
거치적거리다	거치적거리어(거치적거려)	거치적거리니
거칠어지다	거칠어지어(거칠어져)	거칠어지니
건너다	건너	건너니
건너가다	건너가	건너가니
건너다니다	건너다니어(건너다녀)	건너다니니
건너다보다	건너다보아(건너다봐)	건너다보니
건너다보이다	건너다보이어(건너다보여)	건너다보이니
건너뛰다	건너뛰어	건너뛰니
건너보다	건너보아(건너봐)	건너보니
건너오다	건너와	건너오니
건너지르다	건너질러	건너지르니
건네다	건네어(건네)	건네니
건네주다	건네주어(건네줘)	건네주니
건드리다	건드리어(건드려)	건드리니
건들거리다	건들거리어(건들거려)	건들거리니
건방지다	건방지어(건방져)	건방지니
건지다	건지어(건져)	건지니
걷다	걸어	걸으니	걷는
걷다	걷어	걷으니	걷는
걷다	걷어	걷으니	걷는
걷다	걷어	걷으니	걷는
걷어붙이다	걷어붙이어(걷어붙여)	걷어붙이니
걷어올리다	걷어올리어	걷어올려	걷어올리니
걷어차다	걷어차	걷어차니
걷어차이다	걷어차이어	걷어차여	걷어차이니
걷어치우다	걷어치우어(걷어치워)	걷어치우니
걷히다	걷히어(걷혀)	걷히니
걷히다	걷히어(걷혀)	걷히니
걷히다	걷히어(걷혀)	걷히니
걸다	걸어	거니	거오
걸다	걸어	거니	거오
걸근거리다	걸근거리어(걸근거려)	걸근거리니
걸근거리다	걸근거리어(걸근거려)	걸근거리니
걸러내다	걸러내어	걸러내	걸러내니
걸려들다	걸려들어	걸려드니	걸려드오
걸리다	걸리어(걸려)	걸리니
걸리다	걸리어(걸려)	걸리니
걸리다	걸리어	걸려	걸리니
걸리다	걸리어	걸려	걸리니
걸리다	걸리어(걸려)	걸리니
걸리적거리다	걸리적거리어(걸리적거려)	걸리적거리니
걸머메다	걸머메어(걸머메)	걸머메니
걸머지다	걸머지어(걸머져)	걸머지니
걸신들리다	걸신들리어(걸신들려)	걸신들리니
걸어가다	걸어가	걸어가니
걸어나가다	걸어나가	걸어나가니
걸어오다	걸어와	걸어오니
걸어오다	걸어와	걸어오니
걸어오다	걸어와	걸어오니
걸우다	걸우어	걸워	걸우니
걸우다	걸우어(걸워)	걸우니
걸치다	걸치어(걸쳐)	걸치니
걸터눕다	걸터누워	걸터누우니	걸터눕는
걸터타다	걸터타	걸터타니
검어지다	검어지어(검어져)	검어지니
겁나다	겁나	겁나니
겁내다	겁내어(겁내)	겁내니
겁주다	겁주어(겁줘)	겁주니
겉꾸미다	겉꾸미어(겉꾸며)	겉꾸미니
겉돌다	겉돌아	겉도니	겉도오
게두덜거리다	게두덜거리어(게두덜거려)	게두덜거리니
게우다	게우어(게워)	게우니
게을러지다	게을러지어	게을러져	게을러지니
겨누다	겨누어(겨눠)	겨누니
겨루다	겨루어(겨뤄)	겨루니
견디다	견디어(견뎌)	견디니
견주다	견주어(견줘)	견주니
겯다	결어	결으니	겯는
겯다	결어	결으니	겯는
겯다	결어	결으니	겯는
결딴나다	결딴나	결딴나니
결론짓다	결론지어	결론지으니	결론짓는
결리다	결리어(결려)	결리니
결리다	결리어(결려)	결리니
결리다	결리어(결려)	결리니
결말짓다	결말지어	결말지으니	결말짓는
결정짓다	결정지어	결정지으니	결정짓는
결판나다	결판나	결판나니
결판내다	결판내어(결판내)	결판내니
겹쌓이다	겹쌓이어(겹쌓여)	겹쌓이니
겹쳐지다	겹쳐지어(겹쳐져)	겹쳐지니
겹치다	겹치어(겹쳐)	겹치니
경사지다	경사지어(경사져)	경사지니
경치다	경치어(경쳐)	경치니
경치다	경치어(경쳐)	경치니
곁달리다	곁달리어(곁달려)	곁달리니
곁들이다	곁들이어(곁들여)	곁들이니
계면돌다	계면돌아	계면도니	계면도오
계시다	계시어(계셔)	계시니
고다	고아(과)	고니
고꾸라뜨리다	고꾸라뜨리어(고꾸라뜨려)	고꾸라뜨리니
고꾸라지다	고꾸라지어(고꾸라져)	고꾸라지니
고동치다	고동치어(고동쳐)	고동치니
고르다	골라	고르니
고르다	골라	고르니
고르다	골라	고르니
고만두다	고만두어(고만둬)	고만두니
고맙다	고마워	고마우니
고물거리다	고물거리어(고물거려)	고물거리니
고부라지다	고부라지어(고부라져)	고부라지니
고부라지다	고부라지어(고부라져)	고부라지니
고이다	고이어(고여)	고이니
고이다	고이어(고여)	고이니
고이다	고이어	고여	고이니
고이다	고이어	고여	고이니
고장나다	고장나	고장나니
고치다	고치어(고쳐)	고치니
고함치다	고함치어(고함쳐)	고함치니
고해바치다	고해바치어(고해바쳐)	고해바치니
곤두박질치다	곤두박질치어(곤두박질쳐)	곤두박질치니
곤두서다	곤두서	곤두서니
곤두세우다	곤두세우어(곤두세워)	곤두세우니
곤드라지다	곤드라지어(곤드라져)	곤드라지니
곧이듣다	곧이들어	곧이들으니	곧이듣는
곧추세우다	곧추세우어(곧추세워)	곧추세우니
골다	골아	고니	고오
골나다	골나	골나니
골라내다	골라내어(골라내)	골라내니
골리다	골리어(골려)	골리니
곪아터지다	곪아터지어	곪아터져	곪아터지니
곯리다	곯리어(곯려)	곯리니
곯리다	곯리어(곯려)	곯리니
곯리다	곯리어(곯려)	곯리니
곯아떨어지다	곯아떨어지어(곯아떨어져)	곯아떨어지니
공갈치다	공갈치어(공갈쳐)	공갈치니
공들다	공들어	공드니	공드오
공들이다	공들이어(공들여)	공들이니
관두다	관두어(관둬)	관두니
관련짓다	관련지어	관련지으니	관련짓는
괜찮아지다	괜찮아지어	괜찮아져	괜찮아지니
괴다	괴어(괘)	괴니
괴다	괴어(괘)	괴니
괴다	괴어(괘)	괴니
괴다	괴어(괘)	괴니
괴롭히다	괴롭히어(괴롭혀)	괴롭히니
괴어들다	괴어들어	괴어드니	괴어드오
괴이다	괴이어(괴여)	괴이니
괴이다	괴이어(괴여)	괴이니
구겨지다	구겨지어(구겨져)	구겨지니
구기다	구기어(구겨)	구기니
구르다	굴러	구르니
구르다	굴러	구르니
구부러지다	구부러지어(구부러져)	구부러지니
구부리다	구부리어(구부려)	구부리니
구슬리다	구슬리어(구슬려)	구슬리니
구슬지다	구슬지어(구슬져)	구슬지니
구시렁거리다	구시렁거리어(구시렁거려)	구시렁거리니
굳어지다	굳어지어(굳어져)	굳어지니
굳히다	굳히어(굳혀)	굳히니
굴다	굴어	구니	구오
굴다	구니
굴러가다	굴러가	굴러가니
굴러내리다	굴러내리어	굴러내려	굴러내리니
굴러다니다	굴러다니어(굴러다녀)	굴러다니니
굴러떨어지다	굴러떨어지어(굴러떨어져)	굴러떨어지니
굴러오다	굴러와	굴러오니	굴러오너라
굴러오다	굴러와	굴러오니
굴러오다	굴러와	굴러오니
굴리다	굴리어(굴려)	굴리니
굵어지다	굵어지어	굵어져	굵어지니
굶다	굶어	굶으니	굶고	굶는	굶지
굶기다	굶기어(굶겨)	굶기니
굶주리다	굶주리어(굶주려)	굶주리니
굼실거리다	굼실거리어(굼실거려)	굼실거리니
굼틀거리다	굼틀거리어(굼틀거려)	굼틀거리니
굽다	구워	구우니	굽는
굽다	굽어	굽으니	굽는
굽다	구워	구우니	굽는
굽다	굽어	굽으니	굽는
굽신거리다	굽신거리어(굽신거려)	굽신거리니
굽신대다	굽신대어(굽신대)	굽신대니
굽실거리다	굽실거리어(굽실거려)	굽실거리니
굽어보다	굽어보아(굽어봐)	굽어보니
굽어살피다	굽어살피어(굽어살펴)	굽어살피니
굽이지다	굽이지어(굽이져)	굽이지니
굽이치다	굽이치어(굽이쳐)	굽이치니
굽히다	굽히어(굽혀)	굽히니
궁상떨다	궁상떨어	궁상떠니	궁상떠오
궁시렁대다	궁시렁대어	궁시렁대	궁시렁대니
귀기울이다	귀기울이어	귀기울여	귀기울이니
귀담아듣다	귀담아들어	귀담아들으니	귀담아듣는
귀빠지다	귀빠지어(귀빠져)	귀빠지니
규정짓다	규정지어	규정지으니	규정짓는
그늘지다	그늘지어(그늘져)	그늘지니
그러다	그래	그러니
그러모으다	그러모아	그러모으니
그렁거리다	그렁거리어(그렁거려)	그렁거리니
그려지다	그려지어	그려져	그려지니
그르다	글러	그르니
그르다	글러	그르니
그르치다	그르치어(그르쳐)	그르치니
그릇되다	그릇되어(그릇돼)	그릇되니
그리다	그리어(그려)	그리니
그리다	그리어(그려)	그리니
그리워지다	그리워지어(그리워져)	그리워지니
그만두다	그만두어(그만둬)	그만두니
그슬다	그슬어	그스니	그스오
그슬리다	그슬리어(그슬려)	그슬리니
그슬리다	그슬리어(그슬려)	그슬리니
그어주다	그어주어(그어줘)	그어주니
그을다	그을어	그으니	그으오
그을리다	그을리어(그을려)	그을리니
그을리다	그을리어(그을려)	그을리니
그치다	그치어(그쳐)	그치니
근질거리다	근질거리어(근질거려)	근질거리니
글썽거리다	글썽거리어(글썽거려)	글썽거리니
글썽이다	글썽이어(글썽여)	글썽이니
긁다	긁어	긁으니	긁고	긁는	긁지
긁어내다	긁어내어(긁어내)	긁어내니
긁어내리다	긁어내리어(긁어내려)	긁어내리니
긁어모으다	긁어모아	긁어모으니
긁적거리다	긁적거리어(긁적거려)	긁적거리니
긁적이다	긁적이어(긁적여)	긁적이니
긁히다	긁히어(긁혀)	긁히니
금가다	금가	금가니
긋다	그어	그으니	긋는
긋다	그어	그으니	긋는
기다	기어(겨)	기니
기다	기어(겨)	기니
기다리다	기다리어(기다려)	기다리니
기대다	기대어(기대)	기대니
기대다	기대어(기대)	기대니
기대서다	기대서	기대서니
기르다	길러	기르니
기리다	기리어(기려)	기리니
기어가다	기어가	기어가니
기어나오다	기어나와	기어나오니	기어나오너라
기어다니다	기어다니어	기어다녀	기어다니니
기어들다	기어들어	기어드니	기어드오
기어오다	기어와	기어오니	기어오너라
기어오르다	기어올라	기어오르니
기억나다	기억나	기억나니
기우뚱거리다	기우뚱거리어(기우뚱거려)	기우뚱거리니
기울다	기울어	기우니	기우오
기울어지다	기울어지어(기울어져)	기울어지니
기울이다	기울이어(기울여)	기울이니
기웃거리다	기웃거리어(기웃거려)	기웃거리니
기웃대다	기웃대어(기웃대)	기웃대니
기죽이다	기죽이어(기죽여)	기죽이니
긷다	길어	길으니	긷는
길다	길어	기니	기오
길다	길어	기니	기오
길들다	길들어	길드니	길드오
길들이다	길들이어(길들여)	길들이니
길어지다	길어지어(길어져)	길어지니
김매다	김매어(김매)	김매니
김빠지다	김빠지어(김빠져)	김빠지니
김새다	김새어(김새)	김새니
깁다	기워	기우니	깁는
깃들다	깃들어	깃드니	깃드오
깃들이다	깃들이어(깃들여)	깃들이니
깊어지다	깊어지어	깊어져	깊어지니
깊어지다	깊어지어	깊어져	깊어지니
까다	까	까니
까다	까	까니
까다	까	까니
까내리다	까내리어	까내려	까내리니
까뒤집히다	까뒤집히어(까뒤집혀)	까뒤집히니
까딱거리다	까딱거리어(까딱거려)	까딱거리니
까딱거리다	까딱거리어(까딱거려)	까딱거리니
까딱이다	까딱이어(까딱여)	까딱이니
까딱이다	까딱이어(까딱여)	까딱이니
까매지다	까매지어(까매져)	까매지니
까무러치다	까무러치어(까무러쳐)	까무러치니
까물거리다	까물거리어(까물거려)	까물거리니
까발리다	까발리어(까발려)	까발리니
까부라지다	까부라지어(까부라져)	까부라지니
까부라지다	까부라지어(까부라져)	까부라지니
까부르다	까불러	까부르니
까불다	까불어	까부니	까부오
까불다	까부니
까불다	까불어	까부니
까불리다	까불리어(까불려)	까불리니
까불리다	까불리어(까불려)	까불리니
까지다	까지어(까져)	까지니
깎다	깎아	깎으니	깎는
깎아내리다	깎아내리어(깎아내려)	깎아내리니
깎이다	깎이어(깎여)	깎이니
깎이다	깎이어(깎여)	깎이니
깐죽거리다	깐죽거리어(깐죽거려)	깐죽거리니
깔다	깔아	까니	까오
깔다	깔아	까니	까오
깔기다	깔기어(깔겨)	깔기니
깔깔거리다	깔깔거리어(깔깔거려)	깔깔거리니
깔깔대다	깔깔대어(깔깔대)	깔깔대니
깔딱거리다	깔딱거리어(깔딱거려)	깔딱거리니
깔리다	깔리어(깔려)	깔리니
깔보다	깔보아(깔봐)	깔보니
깔보이다	깔보이어(깔보여)	깔보이니
깔아뭉개다	깔아뭉개어(깔아뭉개)	깔아뭉개니
깜박거리다	깜박거리어(깜박거려)	깜박거리니
깜박이다	깜박이어(깜박여)	깜박이니
깜빡거리다	깜빡거리어(깜빡거려)	깜빡거리니
깜빡대다	깜빡대어(깜빡대)	깜빡대니
깜빡이다	깜빡이어(깜빡여)	깜빡이니
깜짝이다	깜짝이어(깜짝여)	깜짝이니
깝살리다	깝살리어(깝살려)	깝살리니
깝죽거리다	깝죽거리어(깝죽거려)	깝죽거리니
깝죽대다	깝죽대어(깝죽대)	깝죽대니
깡충거리다	깡충거리어(깡충거려)	깡충거리니
깨다	깨어(깨)	깨니
깨다	깨어(깨)	깨니
깨다	깨어	깨니
깨다	깨어(깨)	깨니
깨나다	깨나	깨나니
깨닫다	깨달아	깨달으니	깨닫는
깨뜨리다	깨뜨리어(깨뜨려)	깨뜨리니
깨물다	깨물어	깨무니	깨무오
깨부수다	깨부수어(깨부숴)	깨부수니
깨어나다	깨어나	깨어나니
깨어지다	깨어지어(깨어져)	깨어지니
깨우다	깨우어(깨워)	깨우니
깨우치다	깨우치어(깨우쳐)	깨우치니
깨이다	깨이어(깨여)	깨이니
깨지다	깨지어(깨져)	깨지니
깨치다	깨치어(깨쳐)	깨치니
깨트리다	깨트리어(깨트려)	깨트리니
깻박치다	깻박치어(깻박쳐)	깻박치니
꺼꾸러지다	꺼꾸러지어(꺼꾸러져)	꺼꾸러지니
꺼끌거리다	꺼끌거리어(꺼끌거려)	꺼끌거리니
꺼내다	꺼내어(꺼내)	꺼내니
꺼들리다	꺼들리어(꺼들려)	꺼들리니
꺼려지다	꺼려지어(꺼려져)	꺼려지니
꺼리다	꺼리어(꺼려)	꺼리니
꺼지다	꺼지어(꺼져)	꺼지니
꺼지다	꺼지어(꺼져)	꺼지니
꺼트리다	꺼트리어(꺼트려)	꺼트리니
꺾다	꺾어	꺾으니	꺾는
꺾어지다	꺾어지어(꺾어져)	꺾어지니
꺾이다	꺾이어(꺾여)	꺾이니
껄껄거리다	껄껄거리어(껄껄거려)	껄껄거리니
껄떡대다	껄떡대어(껄떡대)	껄떡대니
껌벅거리다	껌벅거리어(껌벅거려)	껌벅거리니
껌벅이다	껌벅이어(껌벅여)	껌벅이니
껌뻑거리다	껌뻑거리어(껌뻑거려)	껌뻑거리니
껌뻑이다	껌뻑이어(껌뻑여)	껌뻑이니
껑충거리다	껑충거리어(껑충거려)	껑충거리니
껴들다	껴들어	껴드니	껴드오
껴묻히다	껴묻히어(껴묻혀)	껴묻히니
껴묻히다	껴묻히어(껴묻혀)	껴묻히니
꼬다	꼬아(꽈)	꼬니
꼬꾸라지다	꼬꾸라지어(꼬꾸라져)	꼬꾸라지니
꼬나들다	꼬나들어	꼬나드니	꼬나드오
꼬나쥐다	꼬나쥐어	꼬나쥐니
꼬느다	꼬나	꼬느니
꼬느다	꼬나	꼬느니
꼬느다	꼬나	꼬느니
꼬드기다	꼬드기어(꼬드겨)	꼬드기니
꼬물거리다	꼬물거리어(꼬물거려)	꼬물거리니
꼬부라들다	꼬부라들어	꼬부라드니	꼬부라드오
꼬부라지다	꼬부라지어	꼬부라져	꼬부라지니
꼬부라지다	꼬부라지어(꼬부라져)	꼬부라지니
꼬부라지다	꼬부라지어(꼬부라져)	꼬부라지니
꼬부리다	꼬부리어(꼬부려)	꼬부리니
꼬불거리다	꼬불거리어(꼬불거려)	꼬불거리니
꼬불치다	꼬불치어(꼬불쳐)	꼬불치니
꼬시다	꼬시어(꼬셔)	꼬시니
꼬이다	꼬이어(꼬여)	꼬이니
꼬이다	꼬이어(꼬여)	꼬이니
꼬이다	꼬이어(꼬여)	꼬이니
꼬집히다	꼬집히어(꼬집혀)	꼬집히니
꼴리다	꼴리어(꼴려)	꼴리니
꼴리다	꼴리어(꼴려)	꼴리니
꼼지락거리다	꼼지락거리어(꼼지락거려)	꼼지락거리니
꼼지락대다	꼼지락대어(꼼지락대)	꼼지락대니
꼼틀거리다	꼼틀거리어(꼼틀거려)	꼼틀거리니
꼽히다	꼽히어(꼽혀)	꼽히니
꽂다	꽂아	꽂으니	꽂는
꽂히다	꽂히어(꽂혀)	꽂히니
꽃피다	꽃피어(꽃펴)	꽃피니
꽃피우다	꽃피우어(꽃피워)	꽃피우니
꾀다	꾀어(꽤)	꾀니
꾀다	꾀어(꽤)	꾀니
꾀다	꾀어(꽤)	꾀니
꾀어내다	꾀어내어(꾀어내)	꾀어내니
꾀어들다	꾀어들어	꾀어드니	꾀어드오
꾀이다	꾀이어(꾀여)	꾀이니
꾸다	꾸어(꿔)	꾸니
꾸다	꾸어(꿔)	꾸니
꾸기다	꾸기어(꾸겨)	꾸기니
꾸리다	꾸리어(꾸려)	꾸리니
꾸며내다	꾸며내어	꾸며내	꾸며내니
꾸물거리다	꾸물거리어(꾸물거려)	꾸물거리니
꾸미다	꾸미어(꾸며)	꾸미니
꾸벅이다	꾸벅이어(꾸벅여)	꾸벅이니
꾸부러지다	꾸부러지어(꾸부러져)	꾸부러지니
꾸부리다	꾸부리어(꾸부려)	꾸부리니
꾸이다	꾸이어(꾸여)	꾸이니
꾸이다	꾸이어(꾸여)	꾸이니
꾸짖다	꾸짖어	꾸짖으니	꾸짖는
꿀꺽거리다	꿀꺽거리어(꿀꺽거려)	꿀꺽거리니
꿀꿀거리다	꿀꿀거리어(꿀꿀거려)	꿀꿀거리니
꿀꿀거리다	꿀꿀거리어(꿀꿀거려)	꿀꿀거리니
꿀리다	꿀리어(꿀려)	꿀리니
꿀리다	꿀리어(꿀려)	꿀리니
꿇다	꿇어	꿇으니	꿇는	꿇소
꿇리다	꿇리어(꿇려)	꿇리니
꿇리다	꿇리어(꿇려)	꿇리니
꿇어앉히다	꿇어앉히어(꿇어앉혀)	꿇어앉히니
꿈꾸다	꿈꾸어(꿈꿔)	꿈꾸니
꿈지럭거리다	꿈지럭거리어(꿈지럭거려)	꿈지럭거리니
꿈틀거리다	꿈틀거리어(꿈틀거려)	꿈틀거리니
꿈틀대다	꿈틀대어(꿈틀대)	꿈틀대니
꿍얼거리다	꿍얼거리어(꿍얼거려)	꿍얼거리니
꿰다	꿰어(꿰)	꿰니
꿰맞추다	꿰맞추어(꿰맞춰)	꿰맞추니
꿰매다	꿰매어(꿰매)	꿰매니
꿰어차다	꿰어차	꿰어차니
꿰이다	꿰이어(꿰여)	꿰이니
꿰지다	꿰지어(꿰져)	꿰지니
꿰차다	꿰차	꿰차니
뀌다	뀌어	뀌니
뀌다	뀌어	뀌니
뀌다	뀌어	뀌니
끄다	꺼	끄니
끄다	꺼	끄니
끄덕거리다	끄덕거리어(끄덕거려)	끄덕거리니
끄덕이다	끄덕이어(끄덕여)	끄덕이니
끄떡이다	끄떡이어(끄떡여)	끄떡이니
끄르다	끌러	끄르니
끄먹거리다	끄먹거리어(끄먹거려)	끄먹거리니
끄물거리다	끄물거리어(끄물거려)	끄물거리니
끄적거리다	끄적거리어(끄적거려)	끄적거리니
끄적이다	끄적이어(끄적여)	끄적이니
끄집어내다	끄집어내어(끄집어내)	끄집어내니
끄집어내리다	끄집어내리어	끄집어내려	끄집어내리니
끅끅거리다	끅끅거리어(끅끅거려)	끅끅거리니
끈적거리다	끈적거리어(끈적거려)	끈적거리니
끈적이다	끈적이어(끈적여)	끈적이니
끊기다	끊기어(끊겨)	끊기니
끊어지다	끊어지어(끊어져)	끊어지니
끊이다	끊이어(끊여)	끊이니
끌다	끌어	끄니	끄오
끌끌거리다	끌끌거리어(끌끌거려)	끌끌거리니
끌끌거리다	끌끌거리어(끌끌거려)	끌끌거리니
끌려가다	끌려가	끌려가니
끌려다니다	끌려다니어(끌려다녀)	끌려다니니
끌려들다	끌려들어	끌려드니	끌려드오
끌려오다	끌려와	끌려오니
끌리다	끌리어	끌려	끌리니
끌리다	끌리어(끌려)	끌리니
끌어가다	끌어가	끌어가니
끌어내다	끌어내어(끌어내)	끌어내니
끌어내리다	끌어내리어(끌어내려)	끌어내리니
끌어당기다	끌어당기어(끌어당겨)	끌어당기니
끌어대다	끌어대어(끌어대)	끌어대니
끌어들이다	끌어들이어(끌어들여)	끌어들이니
끌어모으다	끌어모으니	끌어모아
끌어오다	끌어와	끌어오니
끌어올리다	끌어올리어(끌어올려)	끌어올리니
끓어넘치다	끓어넘치어(끓어넘쳐)	끓어넘치니
끓어오르다	끓어올라	끓어오르니
끓이다	끓이어(끓여)	끓이니
끔뻑거리다	끔뻑거리어(끔뻑거려)	끔뻑거리니
끙끙거리다	끙끙거리어(끙끙거려)	끙끙거리니
끙끙대다	끙끙대어(끙끙대)	끙끙대니
끝나다	끝나	끝나니
끝내다	끝내어(끝내)	끝내니
끝내주다	끝내주어(끝내줘)	끝내주니
끝마치다	끝마치어(끝마쳐)	끝마치니
끝장나다	끝장나	끝장나니
끝장내다	끝장내어(끝장내)	끝장내니
끼다	끼어(껴)	끼니
끼다	끼어(껴)	끼니
끼다	끼어(껴)	끼니
끼어들다	끼어들어	끼어드니	끼어드오
끼얹히다	끼얹히어(끼얹혀)	끼얹히니
끼우다	끼우어(끼워)	끼우니
끼이다	끼이어(끼여)	끼이니
끼이다	끼이어	끼여	끼이니
끼이다	끼이어(끼여)	끼이니
끼적거리다	끼적거리어(끼적거려)	끼적거리니
끼적거리다	끼적거리어(끼적거려)	끼적거리니
끼적대다	끼적대어(끼적대)	끼적대니
끼적대다	끼적대어(끼적대)	끼적대니
끼적이다	끼적이어(끼적여)	끼적이니
끼적이다	끼적이어(끼적여)	끼적이니
끼치다	끼치어(끼쳐)	끼치니
끼치다	끼치어(끼쳐)	끼치니
낄낄거리다	낄낄거리어(낄낄거려)	낄낄거리니
낄낄대다	낄낄대어(낄낄대)	낄낄대니
낑낑거리다	낑낑거리어(낑낑거려)	낑낑거리니
낑낑대다	낑낑대어(낑낑대)	낑낑대니
나다	나	나니
나다	나	나니
나가다	나가	나가니
나가떨어지다	나가떨어지어(나가떨어져)	나가떨어지니
나가자빠지다	나가자빠지어(나가자빠져)	나가자빠지니
나꾸다	나꾸어(나꿔)	나꾸니
나누다	나누어(나눠)	나누니
나누어주다	나누어주어	나누어줘	나누어주니
나누어지다	나누어지어	나누어져	나누어지니
나누이다	나누이어(나누여)	나누이니
나눠주다	나눠주어	나눠줘	나눠주니
나뉘다	나뉘어	나뉘니
나다니다	나다니어(나다녀)	나다니니
나대다	나대어(나대)	나대니
나돌다	나돌아	나도니	나도오
나돌아다니다	나돌아다니어	나돌아다녀	나돌아다니니
나동그라지다	나동그라지어(나동그라져)	나동그라지니
나둥그러지다	나둥그러지어(나둥그러져)	나둥그러지니
나뒹굴다	나뒹굴어	나뒹구니	나뒹구오
나들다	나들어	나드니	나드오
나르다	날라	나르니
나무라다	나무라	나무라니
나부끼다	나부끼어(나부껴)	나부끼니
나불거리다	나불거리어(나불거려)	나불거리니
나불거리다	나불거리어(나불거려)	나불거리니
나빠지다	나빠지어(나빠져)	나빠지니
나서다	나서	나서니
나아가다	나아가	나아가니
나아지다	나아지어(나아져)	나아지니
나오다	나와	나오니
나자빠지다	나자빠지어(나자빠져)	나자빠지니
나타나다	나타나	나타나니
나타내다	나타내어(나타내)	나타내니
낙인찍히다	낙인찍히어(낙인찍혀)	낙인찍히니
낚아내다	낚아내어(낚아내)	낚아내니
낚아올리다	낚아올리어	낚아올려	낚아올리니
낚아채다	낚아채어(낚아채)	낚아채니
낚이다	낚이어(낚여)	낚이니
날다	날아	나니	나오
날다	날아	나니	나오
날다	날아	나니	나오
날뛰다	날뛰어	날뛰니
날려보내다	날려보내어	날려보내	날려보내니
날름거리다	날름거리어(날름거려)	날름거리니
날리다	날리어	날려	날리니
날리다	날리어(날려)	날리니
날리다	날리어(날려)	날리니
날아가다	날아가	날아가니
날아다니다	날아다니어(날아다녀)	날아다니니
날아들다	날아들어	날아드니	날아드오
날아오다	날아와	날아오니
날아오르다	날아올라	날아오르니
날치다	날치어(날쳐)	날치니
남다	남아	남으니
남겨지다	남겨지어(남겨져)	남겨지니
남기다	남기어(남겨)	남기니
남아나다	남아나	남아나니
남아돌다	남아돌아	남아도니	남아도오
납시다	납시어(납셔)	납시니
낫다	나아	나으니
낫다	나아	나으니	낫는
낮아지다	낮아지어	낮아져	낮아지니
낮추다	낮추어(낮춰)	낮추니
낯가리다	낯가리어(낯가려)	낯가리니
낯모르다	낯몰라	낯모르니
낯익히다	낯익히어(낯익혀)	낯익히니
낳다	낳아	낳으니	낳는
낳다	낳아	낳으니	낳는
내다	내어(내)	내니
내다	내어(내)	내니
내가다	내가	내가니
내갈기다	내갈기어(내갈겨)	내갈기니
내걸다	내걸어	내거니	내거오
내걸리다	내걸리어(내걸려)	내걸리니
내깔기다	내깔기어(내깔겨)	내깔기니
내놓다	내놓아(내놔)	내놓으니	내놓는	내놓소
내다보다	내다보아(내다봐)	내다보니
내다보이다	내다보이어(내다보여)	내다보이니
내다팔다	내다팔아	내다파니
내닫다	내달아	내달으니	내닫는
내달다	내달아	내다니	내다오
내달리다	내달리어(내달려)	내달리니
내던지다	내던지어(내던져)	내던지니
내돌리다	내돌리어(내돌려)	내돌리니
내동댕이치다	내동댕이치어(내동댕이쳐)	내동댕이치니
내두르다	내둘러	내두르니
내둘리다	내둘리어(내둘려)	내둘리니
내둘리다	내둘리어(내둘려)	내둘리니
내드리다	내드리어(내드려)	내드리니
내디디다	내디디어(내디뎌)	내디디니
내뚫리다	내뚫리어(내뚫려)	내뚫리니
내뛰다	내뛰어	내뛰니
내려가다	내려가	내려가니
내려놓다	내려놓아(내려놔)	내려놓으니	내려놓는	내려놓소
내려다보다	내려다보아(내려다봐)	내려다보니
내려다보이다	내려다보이어(내려다보여)	내려다보이니
내려디디다	내려디디어(내려디뎌)	내려디디니
내려뜨리다	내려뜨리어(내려뜨려)	내려뜨리니
내려보다	내려보아	내려봐	내려보니
내려보내다	내려보내어(내려보내)	내려보내니
내려서다	내려서	내려서니
내려오다	내려와	내려오니
내려지다	내려지어(내려져)	내려지니
내려치다	내려치어(내려쳐)	내려치니
내리다	내리어(내려)	내리니
내리다	내리어(내려)	내리니
내리갈기다	내리갈기어(내리갈겨)	내리갈기니
내리깔다	내리깔아	내리까니	내리까오
내리깔리다	내리깔리어(내리깔려)	내리깔리니
내리꽂히다	내리꽂히어(내리꽂혀)	내리꽂히니
내리누르다	내리눌러	내리누르니
내리닫다	내리달아	내리달으니	내리닫는
내리달리다	내리달리어	내리달려	내리달리니
내리덮이다	내리덮이어(내리덮여)	내리덮이니
내리뜨다	내리떠	내리뜨니
내리붓다	내리부어	내리부으니	내리붓는
내리비추다	내리비추어(내리비춰)	내리비추니
내리뻗치다	내리뻗치어	내리뻗쳐	내리뻗치니
내리우다	내리우어(내리워)	내리우니
내리쪼이다	내리쪼이어(내리쪼여)	내리쪼이니
내리쬐다	내리쬐어(내리쫴)	내리쬐니
내리치다	내리치어(내리쳐)	내리치니
내립떠보다	내립떠보아(내립떠봐)	내립떠보니
내맡기다	내맡기어(내맡겨)	내맡기니
내맺히다	내맺히어(내맺혀)	내맺히니
내몰다	내몰아	내모니	내모오
내몰리다	내몰리어(내몰려)	내몰리니
내밀다	내밀어	내미니	내미오
내밀리다	내밀리어(내밀려)	내밀리니
내밀치다	내밀치어(내밀쳐)	내밀치니
내바치다	내바치어(내바쳐)	내바치니
내발리다	내발리어(내발려)	내발리니
내버려두다	내버려두어	내버려둬	내버려두니
내버리다	내버리어(내버려)	내버리니
내보다	내보아(내봐)	내보니
내보내다	내보내어(내보내)	내보내니
내보이다	내보이어(내보여)	내보이니
내보이다	내보이어(내보여)	내보이니
내비치다	내비치어(내비쳐)	내비치니
내빼다	내빼어(내빼)	내빼니
내뻗치다	내뻗치어(내뻗쳐)	내뻗치니
내세우다	내세우어(내세워)	내세우니
내쉬다	내쉬어	내쉬니
내쏘다	내쏘아(내쏴)	내쏘니
내어던지다	내어던지어(내어던져)	내어던지니
내어보내다	내어보내어(내어보내)	내어보내니
내오다	내와	내오니
내젓다	내저어	내저으니	내젓는
내주다	내주어(내줘)	내주니
내지르다	내질러	내지르니
내지르다	내질러	내지르니
내질리다	내질리어(내질려)	내질리니
내질리다	내질리어	내질려	내질리니
내쫓기다	내쫓기어(내쫓겨)	내쫓기니
내차다	내차	내차니
내치다	내치어	내쳐	내치니
내키다	내키어(내켜)	내키니
내키다	내키어(내켜)	내키니
내팽개치다	내팽개치어(내팽개쳐)	내팽개치니
냠냠거리다	냠냠거리어(냠냠거려)	냠냠거리니
너덜거리다	너덜거리어(너덜거려)	너덜거리니
너덜대다	너덜대어(너덜대)	너덜대니
너부러지다	너부러지어(너부러져)	너부러지니
너울거리다	너울거리어(너울거려)	너울거리니
너털거리다	너털거리어(너털거려)	너털거리니
너풀거리다	너풀거리어(너풀거려)	너풀거리니
너풀대다	너풀대어(너풀대)	너풀대니
널다	널어	너니	너오
널다	널어	너니	너오
널뛰다	널뛰어	널뛰니
널름거리다	널름거리어(널름거려)	널름거리니
널리다	널리어(널려)	널리니
널리다	널리어(널려)	널리니
널브러지다	널브러지어(널브러져)	널브러지니
넓어지다	넓어지어(넓어져)	넓어지니
넓히다	넓히어(넓혀)	넓히니
넘다	넘어	넘으니
넘겨다보다	넘겨다보아(넘겨다봐)	넘겨다보니
넘겨보다	넘겨보아(넘겨봐)	넘겨보니
넘겨주다	넘겨주어(넘겨줘)	넘겨주니
넘기다	넘기어(넘겨)	넘기니
넘나들다	넘나들어	넘나드니	넘나드오
넘놀다	넘놀아	넘노니	넘노오
넘보다	넘보아(넘봐)	넘보니
넘실거리다	넘실거리어(넘실거려)	넘실거리니
넘실대다	넘실대어(넘실대)	넘실대니
넘어가다	넘어가	넘어가니
넘어뜨리다	넘어뜨리어(넘어뜨려)	넘어뜨리니
넘어서다	넘어서	넘어서니
넘어오다	넘어와	넘어오니
넘어지다	넘어지어(넘어져)	넘어지니
넘쳐나다	넘쳐나	넘쳐나니
넘쳐흐르다	넘쳐흘러	넘쳐흐르니
넘치다	넘치어(넘쳐)	넘치니
넣다	넣어	넣으니	넣는	넣소
노나다	노나	노나니
노닐다	노닐어	노니니	노니오
노닥거리다	노닥거리어(노닥거려)	노닥거리니
노래지다	노래지어(노래져)	노래지니
노려보다	노려보아(노려봐)	노려보니
노리다	노리어(노려)	노리니
노리다	노리어(노려)	노리니
노리다	노리어(노려)	노리니
노망들다	노망들어	노망드니	노망드오
녹다	녹아	녹으니	녹는
녹슬다	녹슬어	녹스니	녹스오
녹아나다	녹아나	녹아나니
녹아내리다	녹아내리어(녹아내려)	녹아내리니
녹아들다	녹아들어	녹아드니	녹아드오
녹아떨어지다	녹아떨어지어(녹아떨어져)	녹아떨어지니
녹이다	녹이어(녹여)	녹이니
놀다	놀아	노니	노오
놀다	놀아	노니	노오
놀라다	놀라	놀라니
놀래다	놀래어(놀래)	놀래니
놀러가다	놀러가	놀러가니
놀러오다	놀러와	놀러오니	놀러오너라
놀리다	놀리어(놀려)	놀리니
놀리다	놀리어(놀려)	놀리니
놀아나다	놀아나	놀아나니
농사짓다	농사지어	농사지으니	농사짓는
높아지다	높아지어(높아져)	높아지니
높이다	높이어(높여)	높이니
놓다	놓아(놔)	놓으니	놓는	놓소
놓아가다	놓아가	놓아가니
놓아두다	놓아두어(놓아둬)	놓아두니
놓아주다	놓아주어(놓아줘)	놓아주니
놓여나다	놓여나	놓여나니
놓이다	놓이어(놓여)	놓이니
놓치다	놓치어(놓쳐)	놓치니
놔두다	놔두어(놔둬)	놔두니
놔주다	놔주어(놔줘)	놔주니
뇌까리다	뇌까리어(뇌까려)	뇌까리니
누다	누어(눠)	누니
누그러들다	누그러들어	누그러드니	누그러드오
누그러뜨리다	누그러뜨리어(누그러뜨려)	누그러뜨리니
누그러지다	누그러지어(누그러져)	누그러지니
누그리다	누그리어(누그려)	누그리니
누레지다	누레지어(누레져)	누레지니
누르다	눌러	누르니
누르다	누르러	누르니
누리다	누리어(누려)	누리니
누리다	누리어(누려)	누리니
누비다	누비어(누벼)	누비니
누이다	누이어(누여)	누이니
누이다	누이어(누여)	누이니
누이다	누이어(누여)	누이니
누이다	누이어(누여)	누이니
눅어지다	눅어지어(눅어져)	눅어지니
눅이다	눅이어(눅여)	눅이니
눈감다	눈감아	눈감으니
눈뜨다	눈떠	눈뜨니
눈멀다	눈멀어	눈머니	눈머오
눈물짓다	눈물지어	눈물지으니	눈물짓는
눈여겨보다	눈여겨보아(눈여겨봐)	눈여겨보니
눈치보다	눈치보아	눈치봐	눈치보니
눈치채다	눈치채어(눈치채)	눈치채니
눋다	눌어	눌으니	눋는
눌러두다	눌러두어(눌러둬)	눌러두니
눌러보다	눌러보아(눌러봐)	눌러보니
눌러살다	눌러살아	눌러사니	눌러사오
눌러쓰다	눌러써	눌러쓰니
눌리다	눌리어(눌려)	눌리니
눌리다	눌리어(눌려)	눌리니
눕다	누워	누우니	눕는
눕다	누워	누우니	눕는
눕다	누워	누우니	눕는
눕다	누워	누우니	눕는
눕히다	눕히어(눕혀)	눕히니
눙치다	눙치어(눙쳐)	눙치니
뉘다	뉘어	뉘니
뉘다	뉘어	뉘니
뉘다	뉘어	뉘니
뉘다	뉘어	뉘니
뉘다	뉘어	뉘니
뉘엿거리다	뉘엿거리어(뉘엿거려)	뉘엿거리니
뉘우치다	뉘우치어(뉘우쳐)	뉘우치니
느끼다	느끼어(느껴)	느끼니
느끼다	느끼어(느껴)	느끼니
느려지다	느려지어(느려져)	느려지니
느물거리다	느물거리어(느물거려)	느물거리니
느즈러지다	느즈러지어(느즈러져)	느즈러지니
늘다	늘어	느니	느오
늘리다	늘리어(늘려)	늘리니
늘어나다	늘어나	늘어나니
늘어놓다	늘어놓아(늘어놔)	늘어놓으니	늘어놓는	늘어놓소
늘어뜨리다	늘어뜨리어(늘어뜨려)	늘어뜨리니
늘어서다	늘어서	늘어서니
늘어지다	늘어지어	늘어지니
늘이다	늘이어(늘여)	늘이니
늘이다	늘이어(늘여)	늘이니
늙어빠지다	늙어빠지어	늙어빠져	늙어빠지니
능글거리다	능글거리어(능글거려)	능글거리니
능글대다	능글대어(능글대)	능글대니
늦어지다	늦어지어(늦어져)	늦어지니
늦자라다	늦자라	늦자라니
늦추다	늦추어(늦춰)	늦추니
늦추어지다	늦추어지어(늦추어져)	늦추어지니
늦춰지다	늦춰지어(늦춰져)	늦춰지니
다가가다	다가가	다가가니
다가들다	다가들어	다가드니	다가드오
다가서다	다가서	다가서니
다가오다	다가와	다가오니
다그다	다가	다그니
다그치다	다그치어(다그쳐)	다그치니
다녀가다	다녀가	다녀가니
다녀오다	다녀와	다녀오니
다니다	다니어(다녀)	다니니
다다르다	다다라	다다르니
다독거리다	다독거리어(다독거려)	다독거리니
다독이다	다독이어(다독여)	다독이니
다되다	다되어(다돼)	다되니
다듬다	다듬어	다듬으니
다듬어지다	다듬어지어(다듬어져)	다듬어지니
다루다	다루어(다뤄)	다루니
다리다	다리어(다려)	다리니
다물다	다물어	다무니	다무오
다스리다	다스리어(다스려)	다스리니
다시다	다시어(다셔)	다시니
다지다	다지어(다져)	다지니
다지다	다지어(다져)	다지니
다치다	다치어(다쳐)	다치니
다치다	다치어(다쳐)	다치니
다투다	다투어(다퉈)	다투니
닥뜨리다	닥뜨리어(닥뜨려)	닥뜨리니
닥쳐오다	닥쳐와	닥쳐오니
닥치다	닥치어(닥쳐)	닥치니
닥치다	닥치어(닥쳐)	닥치니
닦다	닦아	닦으니	닦는
닦아세우다	닦아세우어(닦아세워)	닦아세우니
닦이다	닦이어(닦여)	닦이니
닦이다	닦이어(닦여)	닦이니
단정짓다	단정지어	단정지으니
닫다	닫아	닫으니	닫는
닫다	달아	달으니	닫는
닫아걸다	닫아걸어	닫아거니	닫아거오
닫치다	닫치어(닫쳐)	닫치니
닫히다	닫히어(닫혀)	닫히니
달다	달아	다니	다오
달다	달아	다니	다오
달다	달아	다니	다오
달다	달아	다니	다오
달각거리다	달각거리어(달각거려)	달각거리니
달구다	달구어(달궈)	달구니
달그락거리다	달그락거리어(달그락거려)	달그락거리니
달달거리다	달달거리어(달달거려)	달달거리니
달뜨다	달떠	달뜨니
달라지다	달라지어(달라져)	달라지니
달랑거리다	달랑거리어(달랑거려)	달랑거리니
달래다	달래어(달래)	달래니
달려가다	달려가	달려가니
달려나가다	달려나가	달려나가니
달려나오다	달려나와	달려나오니	달려나오너라
달려들다	달려들어	달려드니	달려드오
달려오다	달려와	달려오니
달리다	달리어(달려)	달리니
달리다	달리어(달려)	달리니
달싹거리다	달싹거리어(달싹거려)	달싹거리니
달싹이다	달싹이어(달싹여)	달싹이니
달아나다	달아나	달아나니
달아내다	달아내어(달아내)	달아내니
달아매다	달아매어(달아매)	달아매니
달아오르다	달아올라	달아오르니
달음박질치다	달음박질치어(달음박질쳐)	달음박질치니
달음질치다	달음질치어(달음질쳐)	달음질치니
달이다	달이어(달여)	달이니
달창나다	달창나	달창나니
닳아빠지다	닳아빠지어(닳아빠져)	닳아빠지니
담그다	담가	담그니
담기다	담기어(담겨)	담기니
담기다	담기어(담겨)	담기니
담아내다	담아내어(담아내)	담아내니
당기다	당기어(당겨)	당기니
닿다	닿아	닿으니	닿는	닿소
대다	대어(대)	대니
대끼다	대끼어(대껴)	대끼니
대끼다	대끼어(대껴)	대끼니
대끼다	대끼어(대껴)	대끼니
대놓다	대놓아	대놔	대놓으니
대들다	대들어	대드니	대드오
대롱거리다	대롱거리어(대롱거려)	대롱거리니
대물리다	대물리어(대물려)	대물리니
대보다	대보아(대봐)	대보니
대주다	대주어	대줘	대주니
대질리다	대질리어(대질려)	대질리니
댕기다	댕기어(댕겨)	댕기니
더뎌지다	더뎌지어(더뎌져)	더뎌지니
더듬거리다	더듬거리어(더듬거려)	더듬거리니
더디다	더디어(더뎌)	더디니
더러워지다	더러워지어(더러워져)	더러워지니
더럽히다	더럽히어(더럽혀)	더럽히니
더워지다	더워지어(더워져)	더워지니
더치다	더치어(더쳐)	더치니
더펄거리다	더펄거리어(더펄거려)	더펄거리니
던지다	던지어(던져)	던지니
덜다	덜어	더니	더오
덜거덕거리다	덜거덕거리어(덜거덕거려)	덜거덕거리니
덜걱거리다	덜걱거리어(덜걱거려)	덜걱거리니
덜겅거리다	덜겅거리어(덜겅거려)	덜겅거리니
덜그럭거리다	덜그럭거리어(덜그럭거려)	덜그럭거리니
덜리다	덜리어(덜려)	덜리니
덜커덩거리다	덜커덩거리어(덜커덩거려)	덜커덩거리니
덜컥거리다	덜컥거리어(덜컥거려)	덜컥거리니
덜컥거리다	덜컥거리어(덜컥거려)	덜컥거리니
덜컹거리다	덜컹거리어(덜컹거려)	덜컹거리니
덜컹거리다	덜컹거리어(덜컹거려)	덜컹거리니
덤벙거리다	덤벙거리어(덤벙거려)	덤벙거리니
덤벙거리다	덤벙거리어(덤벙거려)	덤벙거리니
덤벙대다	덤벙대어(덤벙대)	덤벙대니
덤벙대다	덤벙대어(덤벙대)	덤벙대니
덤벼들다	덤벼들어	덤벼드니	덤벼드오
덤비다	덤비어(덤벼)	덤비니
덥히다	덥히어(덥혀)	덥히니
덧나다	덧나	덧나니
덧나다	덧나	덧나니
덧대다	덧대어(덧대)	덧대니
덧들이다	덧들이어(덧들여)	덧들이니
덧들이다	덧들이어(덧들여)	덧들이니
덧바르다	덧발라	덧바르니
덧보태다	덧보태어(덧보태)	덧보태니
덧붙다	덧붙어	덧붙으니	덧붙는
덧붙이다	덧붙이어(덧붙여)	덧붙이니
덧세우다	덧세우어(덧세워)	덧세우니
덧씌우다	덧씌우어(덧씌워)	덧씌우니
덩어리지다	덩어리지어(덩어리져)	덩어리지니
덮누르다	덮눌러	덮누르니
덮씌우다	덮씌워	덮씌우니
덮어두다	덮어두어	덮어둬	덮어두니
덮어쓰다	덮어써	덮어쓰니
덮어씌우다	덮어씌우어(덮어씌워)	덮어씌우니
덮이다	덮이어(덮여)	덮이니
덮쳐누르다	덮쳐눌러	덮쳐누르니
덮쳐들다	덮쳐들어	덮쳐드니	덮쳐드오
덮치다	덮치어(덮쳐)	덮치니
데다	데어(데)	데니
데려가다	데려가	데려가니
데려다주다	데려다주어(데려다줘)	데려다주니
데려다주다	데려다주어(데려다줘)	데려다주니
데려오다	데려와	데려오니
데우다	데우어(데워)	데우니
데치다	데치어(데쳐)	데치니
도닥거리다	도닥거리어(도닥거려)	도닥거리니
도닥대다	도닥대어(도닥대)	도닥대니
도닥이다	도닥이어(도닥여)	도닥이니
도드라지다	도드라지어(도드라져)	도드라지니
도란거리다	도란거리어(도란거려)	도란거리니
도려내다	도려내어(도려내)	도려내니
도리다	도리어(도려)	도리니
도망가다	도망가	도망가니
도망치다	도망치어(도망쳐)	도망치니
도사리다	도사리어(도사려)	도사리니
도와드리다	도와드리어(도와드려)	도와드리니
도와주다	도와주어(도와줘)	도와주니
도지다	도지어(도져)	도지니
도지다	도지어(도져)	도지니
독나다	독나	독나니
돋구다	돋구어(돋궈)	돋구니
돋보이다	돋보이어(돋보여)	돋보이니
돋아나다	돋아나	돋아나니
돋우다	돋우어(돋워)	돋우니
돋치다	돋치어(돋쳐)	돋치니
돌다	돌아	도니	도오
돌라주다	돌라주어	돌라줘	돌라주니
돌려나다	돌려나	돌려나니
돌려내다	돌려내어(돌려내)	돌려내니
돌려보다	돌려보아	돌려봐	돌려보니
돌려보내다	돌려보내어(돌려보내)	돌려보내니
돌려세우다	돌려세우어(돌려세워)	돌려세우니
돌려쓰다	돌려써	돌려쓰니
돌려주다	돌려주어(돌려줘)	돌려주니
돌리다	돌리어(돌려)	돌리니
돌리다	돌리어(돌려)	돌리니
돌리다	돌리어(돌려)	돌리니
돌보다	돌보아(돌봐)	돌보니
돌아가다	돌아가	돌아가니
돌아가시다	돌아가시어	돌아가셔	돌아가시니
돌아내리다	돌아내리어(돌아내려)	돌아내리니
돌아눕다	돌아누워	돌아누우니	돌아눕는
돌아다니다	돌아다니어(돌아다녀)	돌아다니니
돌아다보다	돌아다보아(돌아다봐)	돌아다보니
돌아들다	돌아들어	돌아드니	돌아드오
돌아보다	돌아보아(돌아봐)	돌아보니
돌아서다	돌아서	돌아서니
돌아오다	돌아와	돌아오니
돌이켜보다	돌이켜보아	돌이켜봐	돌이켜보니
돌이키다	돌이키어(돌이켜)	돌이키니
돕다	도와	도우니	돕는
동그래지다	동그래지어(동그래져)	동그래지니
동나다	동나	동나니
동당거리다	동당거리어(동당거려)	동당거리니
동댕이치다	동댕이치어(동댕이쳐)	동댕이치니
동동거리다	동동거리어(동동거려)	동동거리니
동동거리다	동동거리어(동동거려)	동동거리니
동떨어지다	동떨어지어(동떨어져)	동떨어지니
동여매다	동여매어(동여매)	동여매니
동이다	동이어(동여)	동이니
동트다	동터	동트니
되다	되어(돼)	되니
되다	되어(돼)	되니
되다	되어(돼)	되니
되다	되어(돼)	되니
되가지다	되가지어(되가져)	되가지니
되감기다	되감기어(되감겨)	되감기니
되감기다	되감기어(되감겨)	되감기니
되걸다	되걸어	되거니	되거오
되넘기다	되넘기어(되넘겨)	되넘기니
되뇌다	되뇌어(되놰)	되뇌니
되돌리다	되돌리어(되돌려)	되돌리니
되돌아가다	되돌아가	되돌아가니
되돌아보다	되돌아보아(되돌아봐)	되돌아보니
되돌아서다	되돌아서	되돌아서니
되돌아오다	되돌아와	되돌아오니
되돌이키다	되돌이키어	되돌이켜	되돌이키니
되들어가다	되들어가	되들어가니
되묻다	되물어	되물으니	되묻는
되묻다	되묻어	되묻으니	되묻는
되묻다	되묻어	되묻으니	되묻는
되바라지다	되바라지어(되바라져)	되바라지니
되받아치다	되받아치어(되받아쳐)	되받아치니
되비추다	되비추어(되비춰)	되비추니
되비치다	되비치어	되비쳐	되비치니
되비치다	되비치어(되비쳐)	되비치니
되살리다	되살리어(되살려)	되살리니
되살아나다	되살아나	되살아나니
되삼키다	되삼키어(되삼켜)	되삼키니
되새기다	되새기어(되새겨)	되새기니
되새기다	되새기어(되새겨)	되새기니
되울리다	되울리어(되울려)	되울리니
되작이다	되작이어(되작여)	되작이니
되찾다	되찾아	되찾으니	되찾는
되팔다	되팔아	되파니	되파오
두다	두어(둬)	두니
두근거리다	두근거리어(두근거려)	두근거리니
두근대다	두근대어(두근대)	두근대니
두껍다	두꺼워	두꺼우니
두드러지다	두드러지어(두드러져)	두드러지니
두드리다	두드리어(두드려)	두드리니
두들기다	두들기어(두들겨)	두들기니
두런거리다	두런거리어(두런거려)	두런거리니
두려워지다	두려워지어(두려워져)	두려워지니
두르다	둘러	두르니
두리번거리다	두리번거리어(두리번거려)	두리번거리니
둘러놓다	둘러놓아(둘러놔)	둘러놓으니	둘러놓는	둘러놓소
둘러대다	둘러대어(둘러대)	둘러대니
둘러매다	둘러매어(둘러매)	둘러매니
둘러메다	둘러메어(둘러메)	둘러메니
둘러보다	둘러보아(둘러봐)	둘러보니
둘러서다	둘러서	둘러서니
둘러싸다	둘러싸	둘러싸니
둘러싸이다	둘러싸이어(둘러싸여)	둘러싸이니
둘러쓰다	둘러써	둘러쓰니
둘러씌우다	둘러씌우어(둘러씌워)	둘러씌우니
둘러앉히다	둘러앉히어(둘러앉혀)	둘러앉히니
둘러지다	둘러지어	둘러져	둘러지니
둘러치다	둘러치어(둘러쳐)	둘러치니
둘러치다	둘러치어(둘러쳐)	둘러치니
둘리다	둘리어(둘려)	둘리니
둘리다	둘리어(둘려)	둘리니
둥그러지다	둥그러지어(둥그러져)	둥그러지니
둥그레지다	둥그레지어(둥그레져)	둥그레지니
둥글리다	둥글리어(둥글려)	둥글리니
둥당거리다	둥당거리어(둥당거려)	둥당거리니
뒈지다	뒈지어(뒈져)	뒈지니
뒤덮이다	뒤덮이어(뒤덮여)	뒤덮이니
뒤돌아보다	뒤돌아보아(뒤돌아봐)	뒤돌아보니
뒤돌아서다	뒤돌아서	뒤돌아서니
뒤따라가다	뒤따라가	뒤따라가니
뒤따라오다	뒤따라와	뒤따라오니
뒤따르다	뒤따라	뒤따르니
뒤떨어지다	뒤떨어지어(뒤떨어져)	뒤떨어지니
뒤룩거리다	뒤룩거리어(뒤룩거려)	뒤룩거리니
뒤룩거리다	뒤룩거리어(뒤룩거려)	뒤룩거리니
뒤말리다	뒤말리어(뒤말려)	뒤말리니
뒤미치다	뒤미치어(뒤미쳐)	뒤미치니
뒤바꾸다	뒤바꾸어(뒤바꿔)	뒤바꾸니
뒤바뀌다	뒤바뀌어	뒤바뀌니
뒤보다	뒤보아(뒤봐)	뒤보니
뒤보다	뒤보아(뒤봐)	뒤보니
뒤보다	뒤보아(뒤봐)	뒤보니
뒤섞이다	뒤섞이어(뒤섞여)	뒤섞이니
뒤얽히다	뒤얽히어(뒤얽혀)	뒤얽히니
뒤엉기다	뒤엉기어(뒤엉겨)	뒤엉기니
뒤엉키다	뒤엉키어(뒤엉켜)	뒤엉키니
뒤잇다	뒤이어	뒤이으니	뒤잇는
뒤적거리다	뒤적거리어(뒤적거려)	뒤적거리니
뒤적이다	뒤적이어(뒤적여)	뒤적이니
뒤져내다	뒤져내어(뒤져내)	뒤져내니
뒤지다	뒤지어(뒤져)	뒤지니
뒤지다	뒤지어(뒤져)	뒤지니
뒤집어쓰다	뒤집어써	뒤집어쓰니
뒤집어씌우다	뒤집어씌우어(뒤집어씌워)	뒤집어씌우니
뒤집어지다	뒤집어지어(뒤집어져)	뒤집어지니
뒤집히다	뒤집히어(뒤집혀)	뒤집히니
뒤쫓아가다	뒤쫓아가	뒤쫓아가니
뒤쫓아오다	뒤쫓아와	뒤쫓아오니	뒤쫓아오너라
뒤채다	뒤채어(뒤채)	뒤채니
뒤처지다	뒤처지어(뒤처져)	뒤처지니
뒤척거리다	뒤척거리어(뒤척거려)	뒤척거리니
뒤척이다	뒤척이어(뒤척여)	뒤척이니
뒤쳐지다	뒤쳐지어(뒤쳐져)	뒤쳐지니
뒤치다	뒤치어(뒤쳐)	뒤치니
뒤틀다	뒤틀어	뒤트니	뒤트오
뒤틀리다	뒤틀리어(뒤틀려)	뒤틀리니
뒤틀어지다	뒤틀어지어(뒤틀어져)	뒤틀어지니
뒤흔들다	뒤흔들어	뒤흔드니	뒤흔드오
뒤흔들리다	뒤흔들리어(뒤흔들려)	뒤흔들리니
뒷걸음치다	뒷걸음치어(뒷걸음쳐)	뒷걸음치니
뒹굴다	뒹굴어	뒹구니	뒹구오
드나들다	드나들어	드나드니	드나드오
드날리다	드날리어(드날려)	드날리니
드날리다	드날리어(드날려)	드날리니
드높이다	드높이어(드높여)	드높이니
드러나다	드러나	드러나니
드러내다	드러내어(드러내)	드러내니
드러눕다	드러누워	드러누우니	드러눕는
드리다	드리어(드려)	드리니
드리다	드리어(드려)	드리니
드리다	드리어(드려)	드리니
드리다	드리어(드려)	드리니
드리우다	드리우어(드리워)	드리우니
드리워지다	드리워지어(드리워져)	드리워지니
드세어지다	드세어지어(드세어져)	드세어지니
드세지다	드세지어(드세져)	드세지니
드시다	드시어	드시니
득시글거리다	득시글거리어(득시글거려)	득시글거리니
득실거리다	득실거리어(득실거려)	득실거리니
득실대다	득실대어(득실대)	득실대니
듣다	들어	들으니	듣는
듣다	들어	들으니	듣는
듣다	들어	들으니
들다	들어	드니	드오
들다	들어	드니	드오
들다	들어	드니	드오
들다	들어	드니	드오
들고나다	들고나	들고나니
들고나오다	들고나와	들고나오니
들고나오다	들고나와	들고나오니
들고일어나다	들고일어나	들고일어나니
들까부르다	들까불러	들까부르니
들깨우다	들깨우어(들깨워)	들깨우니
들들대다	들들대어(들들대)	들들대니
들뜨다	들떠	들뜨니
들락거리다	들락거리어(들락거려)	들락거리니
들락날락거리다	들락날락거리어(들락날락거려)	들락날락거리니
들랑거리다	들랑거리어(들랑거려)	들랑거리니
들러가다	들러가	들러가니
들려오다	들려와	들려오니
들려주다	들려주어(들려줘)	들려주니
들르다	들러	들르니
들리다	들리어(들려)	들리니
들리다	들리어(들려)	들리니
들리다	들리어(들려)	들리니
들리다	들리어(들려)	들리니
들먹거리다	들먹거리어(들먹거려)	들먹거리니
들먹이다	들먹이어(들먹여)	들먹이니
들볶이다	들볶이어(들볶여)	들볶이니
들썩거리다	들썩거리어(들썩거려)	들썩거리니
들썩이다	들썩이어(들썩여)	들썩이니
들썽거리다	들썽거리어(들썽거려)	들썽거리니
들썽이다	들썽이어	들썽여	들썽이니
들쑤성거리다	들쑤성거리어	들쑤성거려	들쑤성거리니
들쑤시다	들쑤시어(들쑤셔)	들쑤시니
들쓰다	들써	들쓰니
들씌우다	들씌우어(들씌워)	들씌우니
들어가다	들어가	들어가니
들어가다	들어가	들어가니
들어내다	들어내어(들어내)	들어내니
들어박히다	들어박히어(들어박혀)	들어박히니
들어붓다	들어부어	들어부으니	들어붓는
들어서다	들어서	들어서니
들어앉히다	들어앉히어(들어앉혀)	들어앉히니
들어오다	들어와	들어오니
들어올리다	들어올리어	들어올려	들어올리니
들어주다	들어주어(들어줘)	들어주니
들어차다	들어차	들어차니
들여가다	들여가	들여가니
들여놓다	들여놓아(들여놔)	들여놓으니	들여놓는	들여놓소
들여다보다	들여다보아(들여다봐)	들여다보니
들여다보이다	들여다보이어(들여다보여)	들여다보이니
들여보내다	들여보내어(들여보내)	들여보내니
들여앉히다	들여앉히어(들여앉혀)	들여앉히니
들여오다	들여와	들여오니
들오다	들와	들오니
들이다	들이어	들여	들이니
들이다	들이어	들여	들이니
들이다	들이어(들여)	들이니
들이닥치다	들이닥치어(들이닥쳐)	들이닥치니
들이대다	들이대어(들이대)	들이대니
들이대다	들이대어(들이대)	들이대니
들이덤비다	들이덤비어(들이덤벼)	들이덤비니
들이마시다	들이마시어(들이마셔)	들이마시니
들이마시다	들이마시어(들이마셔)	들이마시니
들이밀다	들이밀어	들이미니	들이미오
들이밀다	들이밀어	들이미니	들이미오
들이박히다	들이박히어(들이박혀)	들이박히니
들이박히다	들이박히어(들이박혀)	들이박히니
들이붓다	들이부어	들이부으니	들이붓는
들이붓다	들이부어	들이부으니	들이붓는
들이쉬다	들이쉬어	들이쉬니
들이차다	들이차	들이차니
들이치다	들이치어(들이쳐)	들이치니
들이치다	들이치어(들이쳐)	들이치니
들이켜다	들이켜	들이켜니
들이키다	들이키어(들이켜)	들이키니
들척거리다	들척거리어(들척거려)	들척거리니
들척이다	들척이어(들척여)	들척이니
들추다	들추어(들춰)	들추니
들추어내다	들추어내어(들추어내)	들추어내니
들춰내다	들춰내어(들춰내)	들춰내니
들치다	들치어(들쳐)	들치니
들치다	들치어	들쳐	들치니
들키다	들키어(들켜)	들키니
등지다	등지어(등져)	등지니
등치다	등치어(등쳐)	등치니
디디다	디디어(디뎌)	디디니
디밀다	디밀어	디미니	디미오
따다	따	따니
따다	따	따니
따끔거리다	따끔거리어(따끔거려)	따끔거리니
따내다	따내어(따내)	따내니
따돌리다	따돌리어(따돌려)	따돌리니
따라가다	따라가	따라가니
따라나서다	따라나서	따라나서니
따라다니다	따라다니어(따라다녀)	따라다니니
따라붙이다	따라붙이어	따라붙여	따라붙이니
따라서다	따라서	따라서니
따라오다	따라와	따라오니
따라잡히다	따라잡히어(따라잡혀)	따라잡히니
따르다	따라	따르니
따르다	따라	따르니
따오다	따와	따오니
따지다	따지어(따져)	따지니
딱딱거리다	딱딱거리어(딱딱거려)	딱딱거리니
딱딱거리다	딱딱거리어(딱딱거려)	딱딱거리니
딸깍거리다	딸깍거리어(딸깍거려)	딸깍거리니
딸랑거리다	딸랑거리어(딸랑거려)	딸랑거리니
딸리다	딸리어(딸려)	딸리니
딸리다	딸리어(딸려)	딸리니
딸싹거리다	딸싹거리어(딸싹거려)	딸싹거리니
땀나다	땀나	땀나니
땅기다	땅기어(땅겨)	땅기니
때다	때어(때)	때니
때다	때어(때)	때니
때다	때어(때)	때니
때려내다	때려내어(때려내)	때려내니
때려눕히다	때려눕히어(때려눕혀)	때려눕히니
때려죽이다	때려죽이어(때려죽여)	때려죽이니
때려치우다	때려치우어(때려치워)	때려치우니
때리다	때리어(때려)	때리니
때리다	때리어(때려)	때리니
때우다	때우어(때워)	때우니
떠가다	떠가	떠가니
떠나다	떠나	떠나니
떠나가다	떠나가	떠나가니
떠나보내다	떠나보내어(떠나보내)	떠나보내니
떠나오다	떠나와	떠나오니
떠내다	떠내어(떠내)	떠내니
떠내려가다	떠내려가	떠내려가니
떠내려오다	떠내려와	떠내려오니
떠넘기다	떠넘기어(떠넘겨)	떠넘기니
떠놓다	떠놓아	떠놔	떠놓으니
떠다니다	떠다니어(떠다녀)	떠다니니
떠다밀다	떠다밀어	떠다미니	떠다미오
떠다밀리다	떠다밀리어	떠다밀려	떠다밀리니
떠다박지르다	떠다박질러	떠다박지르니
떠돌다	떠돌아	떠도니	떠도오
떠돌아다니다	떠돌아다니어(떠돌아다녀)	떠돌아다니니
떠들다	떠들어	떠드니	떠드오
떠들다	떠들어	떠드니	떠드오
떠들어오다	떠들어와	떠들어오니
떠들치다	떠들치어(떠들쳐)	떠들치니
떠듬거리다	떠듬거리어(떠듬거려)	떠듬거리니
떠맡기다	떠맡기어(떠맡겨)	떠맡기니
떠먹이다	떠먹이어(떠먹여)	떠먹이니
떠밀다	떠밀어	떠미니	떠미오
떠밀리다	떠밀리어(떠밀려)	떠밀리니
떠받들다	떠받들어	떠받드니	떠받드오
떠받치다	떠받치어(떠받쳐)	떠받치니
떠벌리다	떠벌리어(떠벌려)	떠벌리니
떠벌이다	떠벌이어(떠벌여)	떠벌이니
떠보다	떠보아(떠봐)	떠보니
떠오다	떠와	떠오니
떠오르다	떠올라	떠오르니
떠올리다	떠올리어(떠올려)	떠올리니
떠죽거리다	떠죽거리어(떠죽거려)	떠죽거리니
떠지다	떠지어	떠져	떠지니
떠지다	떠지어(떠져)	떠지니
떠지다	떠지어(떠져)	떠지니
떨다	떨어	떠니	떠오
떨다	떨어	떠니	떠오
떨구다	떨구어(떨궈)	떨구니
떨리다	떨리어(떨려)	떨리니
떨리다	떨리어(떨려)	떨리니
떨어내다	떨어내어(떨어내)	떨어내니
떨어뜨리다	떨어뜨리어(떨어뜨려)	떨어뜨리니
떨어져나오다	떨어져나와	떨어져나오니	떨어져나오너라
떨어지다	떨어지어(떨어져)	떨어지니
떨어트리다	떨어트리어(떨어트려)	떨어트리니
떨치다	떨치어(떨쳐)	떨치니
떨치다	떨치어(떨쳐)	떨치니
떵떵거리다	떵떵거리어(떵떵거려)	떵떵거리니
떵떵거리다	떵떵거리어(떵떵거려)	떵떵거리니
떼다	떼어(떼)	떼니
떼다	떼어(떼)	떼니
떼밀다	떼밀어	떼미니	떼미오
떼밀리다	떼밀리어(떼밀려)	떼밀리니
떼어놓다	떼어놓아	떼어놔	떼어놓으니
떼이다	떼이어(떼여)	떼이니
떽떽거리다	떽떽거리어(떽떽거려)	떽떽거리니
똑떨어지다	똑떨어지어(똑떨어져)	똑떨어지니
똥그래지다	똥그래지어(똥그래져)	똥그래지니
똥기다	똥기어(똥겨)	똥기니
뚜드리다	뚜드리어(뚜드려)	뚜드리니
뚜들기다	뚜들기어(뚜들겨)	뚜들기니
뚜벅거리다	뚜벅거리어(뚜벅거려)	뚜벅거리니
뚝딱거리다	뚝딱거리어(뚝딱거려)	뚝딱거리니
뚫리다	뚫리어(뚫려)	뚫리니
뚫어지다	뚫어지어(뚫어져)	뚫어지니
뚱그레지다	뚱그레지어(뚱그레져)	뚱그레지니
뛰다	뛰어	뛰니
뛰다	뛰어	뛰니
뛰다	뛰어	뛰니
뛰놀다	뛰놀아	뛰노니	뛰노오
뛰어가다	뛰어가	뛰어가니
뛰어나다	뛰어나	뛰어나니
뛰어나가다	뛰어나가	뛰어나가니
뛰어나오다	뛰어나와	뛰어나오니
뛰어내리다	뛰어내리어(뛰어내려)	뛰어내리니
뛰어놀다	뛰어놀아	뛰어노니	뛰어노오
뛰어다니다	뛰어다니어(뛰어다녀)	뛰어다니니
뛰어들다	뛰어들어	뛰어드니	뛰어드오
뛰어들어가다	뛰어들어가	뛰어들어가니
뛰어들어오다	뛰어들어와	뛰어들어오니	뛰어들어오너라
뛰어오다	뛰어와	뛰어오니
뛰어오르다	뛰어올라	뛰어오르니
뛰쳐나가다	뛰쳐나가	뛰쳐나가니
뛰쳐나오다	뛰쳐나와	뛰쳐나오니
뜨다	떠	뜨니
뜨다	떠	뜨니
뜨다	떠	뜨니
뜨다	떠	뜨니
뜨다	떠	뜨니
뜨거워지다	뜨거워지어(뜨거워져)	뜨거워지니
뜨끔거리다	뜨끔거리어(뜨끔거려)	뜨끔거리니
뜨이다	뜨이어(뜨여)	뜨이니
뜨이다	뜨이어(뜨여)	뜨이니
뜨이다	뜨이어(뜨여)	뜨이니
뜨이다	뜨이어(뜨여)	뜨이니
뜯다	뜯어	뜯으니	뜯는
뜯기다	뜯기어(뜯겨)	뜯기니
뜯기다	뜯기어(뜯겨)	뜯기니
뜯어가다	뜯어가	뜯어가니
뜯어고치다	뜯어고치어(뜯어고쳐)	뜯어고치니
뜯어내다	뜯어내어(뜯어내)	뜯어내니
뜯어말리다	뜯어말리어(뜯어말려)	뜯어말리니
뜯어맞추다	뜯어맞추어	뜯어맞춰	뜯어맞추니
뜯어보다	뜯어보아(뜯어봐)	뜯어보니
뜰먹거리다	뜰먹거리어(뜰먹거려)	뜰먹거리니
띄다	띄어	띄니
띄다	띄어	띄니
띄우다	띄우어(띄워)	띄우니
띄우다	띄우어(띄워)	띄우니
띄우다	띄우어(띄워)	띄우니
띄우다	띄우어(띄워)	띄우니
띠다	띠어(뗘)	띠니
띠우다	띠우어(띠워)	띠우니
마다	마	마니
마르다	말라	마르니
마르다	말라	마르니
마무르다	마물러	마무르니
마무리짓다	마무리지어	마무리지으니
마시다	마시어(마셔)	마시니
마음먹다	마음먹어	마음먹으니	마음먹는
마주대다	마주대어	마주대	마주대니
마주보다	마주보아	마주봐	마주보니
마주서다	마주서	마주서니
마주치다	마주치어(마주쳐)	마주치니
마치다	마치어(마쳐)	마치니
마치다	마치어(마쳐)	마치니
막다	막아	막으니	막는
막가다	막가	막가니
막아서다	막아서	막아서니
막히다	막히어(막혀)	막히니
만나다	만나	만나니
만들다	만들어	만드니	만드오
만들어지다	만들어지어	만들어져	만들어지니
만적거리다	만적거리어	만적거려	만적거리니
만지다	만지어(만져)	만지니
만지작거리다	만지작거리어(만지작거려)	만지작거리니
많아지다	많아지어(많아져)	많아지니
말다	말아	마니	마오
말다	말아	마니	마오
말다	말아	마니	마오
말개지다	말개지어(말개져)	말개지니
말똥거리다	말똥거리어(말똥거려)	말똥거리니
말라비틀어지다	말라비틀어지어(말라비틀어져)	말라비틀어지니
말라빠지다	말라빠지어(말라빠져)	말라빠지니
말려들다	말려들어	말려드니	말려드오
말리다	말리어(말려)	말리니
말리다	말리어(말려)	말리니
말미암다	말미암아	말미암으니
말씀드리다	말씀드리어	말씀드려	말씀드리니
맑아지다	맑아지어(맑아져)	맑아지니
맑히다	맑히어(맑혀)	맑히니
맛보다	맛보아(맛봐)	맛보니
망가뜨리다	망가뜨리어(망가뜨려)	망가뜨리니
망가지다	망가지어(망가져)	망가지니
망그러지다	망그러지어(망그러져)	망그러지니
망설거리다	망설거리어(망설거려)	망설거리니
망설이다	망설이어(망설여)	망설이니
망울지다	망울지어(망울져)	망울지니
망치다	망치어(망쳐)	망치니
맞다	맞아	맞으니	맞는
맞다	맞아	맞으니	맞는
맞다	맞아	맞으니	맞는
맞겨루다	맞겨루어(맞겨뤄)	맞겨루니
맞닥뜨리다	맞닥뜨리어(맞닥뜨려)	맞닥뜨리니
맞대다	맞대어(맞대)	맞대니
맞두다	맞두어(맞둬)	맞두니
맞들다	맞들어	맞드니	맞드오
맞먹다	맞먹어	맞먹으니	맞먹는
맞물다	맞물어	맞무니	맞무오
맞물리다	맞물리어(맞물려)	맞물리니
맞바꾸다	맞바꾸어(맞바꿔)	맞바꾸니
맞받아치다	맞받아치어(맞받아쳐)	맞받아치니
맞보다	맞보아(맞봐)	맞보니
맞부딪치다	맞부딪치어(맞부딪쳐)	맞부딪치니
맞부비다	맞부비어	맞부벼	맞부비니
맞붙이다	맞붙이어(맞붙여)	맞붙이니
맞비비다	맞비비어(맞비벼)	맞비비니
맞서다	맞서	맞서니
맞세우다	맞세우어(맞세워)	맞세우니
맞싸우다	맞싸우어(맞싸워)	맞싸우니
맞아들이다	맞아들이어(맞아들여)	맞아들이니
맞아떨어지다	맞아떨어지어(맞아떨어져)	맞아떨어지니
맞장구치다	맞장구치어(맞장구쳐)	맞장구치니
맞추다	맞추어(맞춰)	맞추니
맞히다	맞히어	맞혀	맞히니
맞히다	맞히어(맞혀)	맞히니
맞히다	맞히어(맞혀)	맞히니
맞히다	맞히어(맞혀)	맞히니
맞히다	맞히어(맞혀)	맞히니
맡다	맡아	맡으니	맡는
맡다	맡아	맡으니	맡는
맡기다	맡기어(맡겨)	맡기니
맡아보다	맡아보아(맡아봐)	맡아보니
매다	매어(매)	매니
매다	매어(매)	매니
매다	매어	매	매니
매기다	매기어(매겨)	매기니
매달다	매달아	매다니	매다오
매달리다	매달리어(매달려)	매달리니
매듭짓다	매듭지어	매듭지으니	매듭짓는
매만지다	매만지어(매만져)	매만지니
매슥거리다	매슥거리어(매슥거려)	매슥거리니
매어달리다	매어달리어	매어달려	매어달리니
매이다	매이어(매여)	매이니
매이다	매이어(매여)	매이니
매이다	매이어(매여)	매이니
맥빠지다	맥빠지어	맥빠져	맥빠지니
맴돌다	맴돌아	맴도니	맴도오
맺다	맺어	맺으니	맺는
맺어지다	맺어지어(맺어져)	맺어지니
맺히다	맺히어(맺혀)	맺히니
머무르다	머물러	머무르니
머물다	머무니
머뭇거리다	머뭇거리어(머뭇거려)	머뭇거리니
머뭇대다	머뭇대어(머뭇대)	머뭇대니
먹다	먹어	먹으니	먹는
먹다	먹어	먹으니	먹는
먹고살다	먹고살아	먹고사니	먹고사오
먹이다	먹이어(먹여)	먹이니
먹혀들다	먹혀들어	먹혀드니	먹혀드오
먹혀들다	먹혀들어	먹혀드니	먹혀드오
먹히다	먹히어(먹혀)	먹히니
멀다	멀어	머니	머오
멀다	멀어	머니	머오
멀어지다	멀어지어(멀어져)	멀어지니
멈추다	멈추어(멈춰)	멈추니
멈칫거리다	멈칫거리어(멈칫거려)	멈칫거리니
멍들다	멍들어	멍드니	멍드오
멍들이다	멍들이어	멍들여	멍들이니
메다	메어(메)	메니
메다	메어(메)	메니
메다	메어(메)	메니
메기다	메기어(메겨)	메기니
메기다	메기어(메겨)	메기니
메꾸다	메꾸어(메꿔)	메꾸니
메슥거리다	메슥거리어(메슥거려)	메슥거리니
메아리치다	메아리치어(메아리쳐)	메아리치니
메어붙이다	메어붙이어(메어붙여)	메어붙이니
메어치다	메어치어(메어쳐)	메어치니
메우다	메우어(메워)	메우니
메우다	메우어(메워)	메우니
메이다	메이어	메여	메이니
메치다	메치어(메쳐)	메치니
모나다	모나	모나니
모내다	모내어	모내	모내니
모내다	모내어(모내)	모내니
모르다	몰라	모르니
모셔다드리다	모셔다드리어(모셔다드려)	모셔다드리니
모셔다드리다	모셔다드리어(모셔다드려)	모셔다드리니
모시다	모시어(모셔)	모시니
모아들이다	모아들이어(모아들여)	모아들이니
모양내다	모양내어(모양내)	모양내니
모여들다	모여들어	모여드니	모여드오
모여오다	모여와	모여오니
모으다	모아	모으니
모이다	모이어(모여)	모이니
모이다	모이어(모여)	모이니
모자라다	모자라	모자라니
모지라지다	모지라지어(모지라져)	모지라지니
목매다	목매어(목매)	목매니
목매달다	목매달아	목매다니	목매다오
목메다	목메어(목메)	목메니
목쉬다	목쉬어	목쉬니
몰다	몰아	모니	모오
몰라보다	몰라보아(몰라봐)	몰라보니
몰라주다	몰라주어(몰라줘)	몰라주니
몰려가다	몰려가	몰려가니
몰려나다	몰려나	몰려나니
몰려나가다	몰려나가	몰려나가니
몰려나오다	몰려나와	몰려나오니
몰려다니다	몰려다니어(몰려다녀)	몰려다니니
몰려들다	몰려들어	몰려드니	몰려드오
몰려서다	몰려서	몰려서니
몰려오다	몰려와	몰려오니
몰리다	몰리어(몰려)	몰리니
몰아가다	몰아가	몰아가니
몰아내다	몰아내어(몰아내)	몰아내니
몰아닥치다	몰아닥치어(몰아닥쳐)	몰아닥치니
몰아대다	몰아대어(몰아대)	몰아대니
몰아붙이다	몰아붙이어(몰아붙여)	몰아붙이니
몰아세우다	몰아세우어(몰아세워)	몰아세우니
몰아쉬다	몰아쉬어	몰아쉬니
몰아오다	몰아와	몰아오니
몰아주다	몰아주어(몰아줘)	몰아주니
몰아치다	몰아치어(몰아쳐)	몰아치니
몸부림치다	몸부림치어(몸부림쳐)	몸부림치니
몸서리치다	몸서리치어(몸서리쳐)	몸서리치니
몸져눕다	몸져누워	몸져누우니	몸져눕는
못되다	못되어(못돼)	못되니
못박히다	못박히어	못박혀	못박히니
못살다	못살아	못사니	못사오
못생기다	못생기어(못생겨)
못쓰다	못써	못쓰니
못주다	못주어(못줘)	못주니
몽그라지다	몽그라지어(몽그라져)	몽그라지니
몽치다	몽치어(몽쳐)	몽치니
무거워지다	무거워지어(무거워져)	무거워지니
무너뜨리다	무너뜨리어(무너뜨려)	무너뜨리니
무너지다	무너지어(무너져)	무너지니
무느다	무너	무느니
무뎌지다	무뎌지어(무뎌져)	무뎌지니
무디어지다	무디어지어(무디어져)	무디어지니
무르다	물러	무르니
무르다	물러	무르니
무르다	물러	무르니
무릅쓰다	무릅써	무릅쓰니
무지르다	무질러	무지르니
무지르다	무질러	무지르니
무찌르다	무찔러	무찌르니
무치다	무치어(무쳐)	무치니
묵다	묵어	묵으니	묵는
묵다	묵어	묵으니	묵는
묵어가다	묵어가	묵어가니
묵히다	묵히어(묵혀)	묵히니
묶다	묶어	묶으니	묶는
묶어가다	묶어가	묶어가니
묶이다	묶이어(묶여)	묶이니
문드러지다	문드러지어(문드러져)	문드러지니
문지르다	문질러	문지르니
묻다	물어	물으니	묻고
묻다	묻어	묻으니	묻는
묻다	묻어	묻으니	묻는
묻어가다	묻어가	묻어가니
묻어나다	묻어나	묻어나니
묻어오다	묻어와	묻어오니
묻잡다	묻자와	묻자오니	묻잡는
묻히다	묻히어(묻혀)	묻히니
묻히다	묻히어(묻혀)	묻히니
물다	물어	무니	무오
물다	물어	무니	무오
물다	물어	무니	무오
물결치다	물결치어(물결쳐)	물결치니
물구나무서다	물구나무서	물구나무서니
물들다	물들어	물드니	물드오
물들이다	물들이어(물들여)	물들이니
물러가다	물러가	물러가니
물러나다	물러나	물러나니
물러서다	물러서	물러서니
물러오다	물러와	물러오니
물러지다	물러지어(물러져)	물러지니
물려주다	물려주어(물려줘)	물려주니
물리다	물리어(물려)	물리니
물리다	물리어(물려)	물리니
물리다	물리어(물려)	물리니
물리다	물리어	물려	물리니
물리다	물리어	물려	물리니
물리치다	물리치어(물리쳐)	물리치니
물밀다	물밀어	물미니	물미오
물씬거리다	물씬거리어	물씬거려	물씬거리니
물씬거리다	물씬거리어(물씬거려)	물씬거리니
물어내다	물어내어(물어내)	물어내니
물어내다	물어내어(물어내)	물어내니
물어뜯기다	물어뜯기어	물어뜯겨	물어뜯기니
물어보다	물어보아(물어봐)	물어보니
물오르다	물올라	물오르니
물커지다	물커지어(물커져)	물커지니
물크러지다	물크러지어(물크러져)	물크러지니
묽어지다	묽어지어(묽어져)	묽어지니
뭉개다	뭉개어(뭉개)	뭉개니
뭉개다	뭉개어(뭉개)	뭉개니
뭉개지다	뭉개지어(뭉개져)	뭉개지니
뭉거지다	뭉거지어(뭉거져)	뭉거지니
뭉그러지다	뭉그러지어(뭉그러져)	뭉그러지니
뭉글거리다	뭉글거리어(뭉글거려)	뭉글거리니
뭉뚱그리다	뭉뚱그리어(뭉뚱그려)	뭉뚱그리니
뭉치다	뭉치어(뭉쳐)	뭉치니
뭉크러지다	뭉크러지어(뭉크러져)	뭉크러지니
뭉클거리다	뭉클거리어(뭉클거려)	뭉클거리니
뭉텅이지다	뭉텅이지어(뭉텅이져)	뭉텅이지니
미끄러뜨리다	미끄러뜨리어(미끄러뜨려)	미끄러뜨리니
미끄러지다	미끄러지어(미끄러져)	미끄러지니
미끈거리다	미끈거리어(미끈거려)	미끈거리니
미끌거리다	미끌거리어	미끌거려	미끌거리니
미루다	미루어(미뤄)	미루니
미루적거리다	미루적거리어(미루적거려)	미루적거리니
미어지다	미어지어(미어져)	미어지니
미어터지다	미어터지어(미어터져)	미어터지니
미워지다	미워지어(미워져)	미워지니
미이다	미이어(미여)	미이니
미적거리다	미적거리어(미적거려)	미적거리니
미치다	미치어(미쳐)	미치니
미치다	미치어(미쳐)	미치니
믿다	믿어	믿으니	믿는
믿기다	믿기어(믿겨)	믿기니
믿어지다	믿어지어	믿어져	믿어지니
밀다	밀어	미니	미오
밀려가다	밀려가	밀려가니
밀려나다	밀려나	밀려나니
밀려나오다	밀려나와	밀려나오니
밀려들다	밀려들어	밀려드니	밀려드오
밀려오다	밀려와	밀려오니
밀리다	밀리어(밀려)	밀리니
밀리다	밀리어(밀려)	밀리니
밀물지다	밀물지어(밀물져)	밀물지니
밀어내다	밀어내어(밀어내)	밀어내니
밀어닥치다	밀어닥치어(밀어닥쳐)	밀어닥치니
밀어뜨리다	밀어뜨리어(밀어뜨려)	밀어뜨리니
밀어붙이다	밀어붙이어(밀어붙여)	밀어붙이니
밀어젖히다	밀어젖히어(밀어젖혀)	밀어젖히니
밀어제치다	밀어제치어(밀어제쳐)	밀어제치니
밀어주다	밀어주어(밀어줘)	밀어주니
밀쳐놓다	밀쳐놓아(밀쳐놔)	밀쳐놓으니	밀쳐놓는	밀쳐놓소
밀치다	밀치어(밀쳐)	밀치니
밉보이다	밉보이어(밉보여)	밉보이니
밑돌다	밑돌아	밑도니	밑도오
밑지다	밑지어(밑져)	밑지니
바글대다	바글대어(바글대)	바글대니
바꾸다	바꾸어(바꿔)	바꾸니
바꿔치다	바꿔치어	바꿔쳐	바꿔치니
바뀌다	바뀌어	바뀌니
바닥나다	바닥나	바닥나니
바둥거리다	바둥거리어(바둥거려)	바둥거리니
바라다	바라	바라니
바라다보다	바라다보아(바라다봐)	바라다보니
바라다보이다	바라다보이어(바라다보여)	바라다보이니
바라보다	바라보아(바라봐)	바라보니
바라보이다	바라보이어(바라보여)	바라보이니
바라지다	바라지어(바라져)	바라지니
바람나다	바람나	바람나니
바래다	바래어(바래)	바래니
바래다	바래어(바래)	바래니
바래다주다	바래다주어(바래다줘)	바래다주니
바로잡다	바로잡아	바로잡으니	바로잡는
바로잡히다	바로잡히어(바로잡혀)	바로잡히니
바르다	발라	바르니
바르다	발라	바르니
바르다	발라	바르니
바르다	발라	바르니
바빠지다	바빠지어	바빠져	바빠지니
바쁘다	바빠	바쁘니
바삭거리다	바삭거리어(바삭거려)	바삭거리니
바스락거리다	바스락거리어(바스락거려)	바스락거리니
바스러지다	바스러지어(바스러져)	바스러지니
바스러지다	바스러지어(바스러져)	바스러지니
바치다	바치어(바쳐)	바치니
바치다	바치어(바쳐)	바치니
박다	박아	박으니	박는
박살나다	박살나	박살나니
박이다	박이어(박여)	박이니
박이다	박이어(박여)	박이니
박차다	박차	박차니
박히다	박히어(박혀)	박히니
반기다	반기어(반겨)	반기니
반들거리다	반들거리어(반들거려)	반들거리니
반들거리다	반들거리어(반들거려)	반들거리니
반들대다	반들대어(반들대)	반들대니
반들대다	반들대어(반들대)	반들대니
반짝거리다	반짝거리어(반짝거려)	반짝거리니
반짝이다	반짝이어(반짝여)	반짝이니
받다	받아	받으니	받는
받다	받아	받으니	받는
받들다	받들어	받드니	받드오
받아넘기다	받아넘기어(받아넘겨)	받아넘기니
받아들이다	받아들이어(받아들여)	받아들이니
받아쓰다	받아써	받아쓰니
받아치다	받아치어(받아쳐)	받아치니
받잡다	받자와	받자오니	받잡는
받쳐들다	받쳐들어	받쳐드니
받치다	받치어(받쳐)	받치니
받치다	받치어(받쳐)	받치니
받히다	받히어(받혀)	받히니
받히다	받히어(받혀)	받히니
발가벗기다	발가벗기어(발가벗겨)	발가벗기니
발개지다	발개지어(발개져)	발개지니
발기다	발기어(발겨)	발기니
발끈거리다	발끈거리어(발끈거려)	발끈거리니
발라내다	발라내어(발라내)	발라내니
발라맞추다	발라맞추어(발라맞춰)	발라맞추니
발랑거리다	발랑거리어(발랑거려)	발랑거리니
발리다	발리어(발려)	발리니
발리다	발리어(발려)	발리니
발리다	발리어(발려)	발리니
발리다	발리어(발려)	발리니
발리다	발리어(발려)	발리니
발맞추다	발맞추어(발맞춰)	발맞추니
발붙이다	발붙이어(발붙여)	발붙이니
밝아지다	밝아지어(밝아져)	밝아지니
밝혀내다	밝혀내어(밝혀내)	밝혀내니
밝혀지다	밝혀지어(밝혀져)	밝혀지니
밝히다	밝히어(밝혀)	밝히니
밟다	밟아	밟으니	밟고	밟는	밟지
밟히다	밟히어	밟혀	밟히니
밟히다	밟히어(밟혀)	밟히니
밤새다	밤새어(밤새)	밤새니
밤새우다	밤새우어(밤새워)	밤새우니
방울지다	방울지어(방울져)	방울지니
밭이다	밭이어(밭여)	밭이니
밭이다	밭이어(밭여)	밭이니
밭치다	밭치어(밭쳐)	밭치니
배다	배어(배)	배니
배다	배어(배)	배니
배다	배어(배)	배니
배겨나다	배겨나	배겨나니
배고프다	배고파	배고프니
배기다	배기어(배겨)	배기니
배기다	배기어(배겨)	배기니
배리다	배리어(배려)	배리니
배부르다	배불러	배부르니
배어나다	배어나	배어나니
배어들다	배어들어	배어드니	배어드오
배우다	배우어(배워)	배우니
뱅글거리다	뱅글거리어(뱅글거려)	뱅글거리니
뱉다	뱉어	뱉으니	뱉는
버그러지다	버그러지어(버그러져)	버그러지니
버금가다	버금가	버금가니
버둥거리다	버둥거리어(버둥거려)	버둥거리니
버둥대다	버둥대어(버둥대)	버둥대니
버둥질치다	버둥질치어	버둥질쳐	버둥질치니
버드러지다	버드러지어(버드러져)	버드러지니
버럭대다	버럭대어	버럭대	버럭대니
버려두다	버려두어(버려둬)	버려두니
버려지다	버려지어(버려져)	버려지니
버르적거리다	버르적거리어(버르적거려)	버르적거리니
버리다	버리어(버려)	버리니
버무려지다	버무려지어(버무려져)	버무려지니
버무리다	버무리어(버무려)	버무리니
버물리다	버물리어(버물려)	버물리니
버물리다	버물리어(버물려)	버물리니
버석거리다	버석거리어(버석거려)	버석거리니
버스러지다	버스러지어(버스러져)	버스러지니
버티다	버티어(버텨)	버티니
벅차오르다	벅차올라	벅차오르니
번득이다	번득이어(번득여)	번득이니
번들거리다	번들거리어(번들거려)	번들거리니
번들거리다	번들거리어(번들거려)	번들거리니
번들대다	번들대어(번들대)	번들대니
번들대다	번들대어(번들대)	번들대니
번뜩이다	번뜩이어(번뜩여)	번뜩이니
번지다	번지어(번져)	번지니
번지다	번지어(번져)	번지니
번질거리다	번질거리어(번질거려)	번질거리니
번쩍거리다	번쩍거리어(번쩍거려)	번쩍거리니
번쩍이다	번쩍이어(번쩍여)	번쩍이니
벌다	벌어	버니	버오
벌다	벌어	버니	버오
벌다	벌어	버니	버오
벌거벗기다	벌거벗기어(벌거벗겨)	벌거벗기니
벌게지다	벌게지어(벌게져)	벌게지니
벌떡거리다	벌떡거리어(벌떡거려)	벌떡거리니
벌렁거리다	벌렁거리어(벌렁거려)	벌렁거리니
벌룽거리다	벌룽거리어(벌룽거려)	벌룽거리니
벌룽거리다	벌룽거리어(벌룽거려)	벌룽거리니
벌름거리다	벌름거리어(벌름거려)	벌름거리니
벌리다	벌리어(벌려)	벌리니
벌리다	벌리어	벌려	벌리니
벌리다	벌리어(벌려)	벌리니
벌벌대다	벌벌대어(벌벌대)	벌벌대니
벌벌대다	벌벌대어(벌벌대)	벌벌대니
벌서다	벌서	벌서니
벌어들이다	벌어들이어(벌어들여)	벌어들이니
벌어지다	벌어지어(벌어져)	벌어지니
벌어지다	벌어지어(벌어져)	벌어지니
벌이다	벌이어(벌여)	벌이니
벌주다	벌주어(벌줘)	벌주니
법석거리다	법석거리어(법석거려)	법석거리니
벗겨지다	벗겨지어(벗겨져)	벗겨지니
벗기다	벗기어(벗겨)	벗기니
벗기다	벗기어(벗겨)	벗기니
벗어나다	벗어나	벗어나니
벗어던지다	벗어던지어(벗어던져)	벗어던지니
벗어부치다	벗어부치어(벗어부쳐)	벗어부치니
벗어젖히다	벗어젖히어(벗어젖혀)	벗어젖히니
벗어지다	벗어지어(벗어져)	벗어지니
벙긋거리다	벙긋거리어(벙긋거려)	벙긋거리니
벙긋거리다	벙긋거리어(벙긋거려)	벙긋거리니
베다	베어(베)	베니
베다	베어(베)	베니
베끼다	베끼어(베껴)	베끼니
베이다	베이어(베여)	베이니
베풀다	베풀어	베푸니	베푸오
벼르다	별러	벼르니
벼르다	별러	벼르니
벼리다	벼리어(벼려)	벼리니
병나다	병나	병나니
병들다	병들어	병드니	병드오
보다	보아(봐)	보니
보내다	보내어(보내)	보내니
보내오다	보내와	보내오니
보드득거리다	보드득거리어(보드득거려)	보드득거리니
보살피다	보살피어(보살펴)	보살피니
보아주다	보아주어(보아줘)	보아주니
보이다	보이어(보여)	보이니
보이다	보이어(보여)	보이니
보채다	보채어(보채)	보채니
보태다	보태어(보태)	보태니
복받치다	복받치어(복받쳐)	복받치니
복작거리다	복작거리어(복작거려)	복작거리니
복작대다	복작대어(복작대)	복작대니
본뜨다	본떠	본뜨니
볼가지다	볼가지어(볼가져)	볼가지니
봐버리다	봐버리어	봐버려	봐버리니
봐주다	봐주어(봐줘)	봐주니
뵈다	뵈어(봬)	뵈니
뵈다	뵈어(봬)	뵈니
뵈다	뵈어(봬)	뵈니
부글대다	부글대어(부글대)	부글대니
부끄러워지다	부끄러워지어(부끄러워져)	부끄러워지니
부닐다	부닐어	부니니	부니오
부닥뜨리다	부닥뜨리어(부닥뜨려)	부닥뜨리니
부닥치다	부닥치어(부닥쳐)	부닥치니
부대끼다	부대끼어(부대껴)	부대끼니
부도나다	부도나	부도나니
부도내다	부도내어(부도내)	부도내니
부둥키다	부둥키어(부둥켜)	부둥키니
부딪치다	부딪치어(부딪쳐)	부딪치니
부딪히다	부딪히어(부딪혀)	부딪히니
부라리다	부라리어(부라려)	부라리니
부러뜨리다	부러뜨리어(부러뜨려)	부러뜨리니
부러지다	부러지어(부러져)	부러지니
부려쓰다	부려써	부려쓰니
부르다	불러	부르니
부르다	불러	부르니
부르대다	부르대어(부르대)	부르대니
부르쥐다	부르쥐어	부르쥐니
부르짖다	부르짖어	부르짖으니	부르짖는
부르트다	부르터	부르트니
부릅뜨다	부릅떠	부릅뜨니
부리다	부리어(부려)	부리니
부리다	부리어(부려)	부리니
부리다	부리어	부려	부리니
부서뜨리다	부서뜨리어(부서뜨려)	부서뜨리니
부서지다	부서지어(부서져)	부서지니
부수다	부수어(부숴)	부수니
부스러뜨리다	부스러뜨리어(부스러뜨려)	부스러뜨리니
부스러지다	부스러지어(부스러져)	부스러지니
부스럭거리다	부스럭거리어(부스럭거려)	부스럭거리니
부슬거리다	부슬거리어(부슬거려)	부슬거리니
부시다	부시어(부셔)	부시니
부시다	부시어(부셔)	부시니
부시다	부시어(부셔)	부시니
부어오르다	부어올라	부어오르니
부어터지다	부어터지어(부어터져)	부어터지니
부추기다	부추기어(부추겨)	부추기니
부치다	부치어(부쳐)	부치니
부치다	부치어(부쳐)	부치니
부치다	부치어(부쳐)	부치니
부치다	부치어(부쳐)	부치니
부치다	부치어(부쳐)	부치니
부탁드리다	부탁드리어	부탁드려	부탁드리니
부풀다	부풀어	부푸니	부푸오
부풀리다	부풀리어(부풀려)	부풀리니
부풀어오르다	부풀어올라	부풀어오르니
북돋우다	북돋우어(북돋워)	북돋우니
북받치다	북받치어(북받쳐)	북받치니
북적거리다	북적거리어(북적거려)	북적거리니
북적대다	북적대어(북적대)	북적대니
북적이다	북적이어(북적여)	북적이니
분지르다	분질러	분지르니
붇다	불어	불으니	붇는
불다	불어	부니	부오
불거지다	불거지어(불거져)	불거지니
불나다	불나	불나니
불러내다	불러내어(불러내)	불러내니
불러들이다	불러들이어(불러들여)	불러들이니
불러모으다	불러모아	불러모으니
불러오다	불러와	불러오니
불러올리다	불러올리어(불러올려)	불러올리니
불러일으키다	불러일으키어(불러일으켜)	불러일으키니
불려가다	불려가	불려가니
불려다니다	불려다니어	불려다녀	불려다니니
불려오다	불려와	불려오니
불리다	불리어(불려)	불리니
불리다	불리어(불려)	불리니
불리다	불리어(불려)	불리니
불리다	불리어(불려)	불리니
불리다	불리어(불려)	불리니
불붙이다	불붙이어(불붙여)	불붙이니
불사르다	불살라	불사르니
불어나다	불어나	불어나니
불어닥치다	불어닥치어(불어닥쳐)	불어닥치니
불어오다	불어와	불어오니
불어치다	불어치어(불어쳐)	불어치니
불어터지다	불어터지어	불어터져	불어터지니
불타다	불타	불타니
불타오르다	불타올라	불타오르니
불태우다	불태우어(불태워)	불태우니
붉어지다	붉어지어(붉어져)	붉어지니
붉히다	붉히어(붉혀)	붉히니
붐비다	붐비어(붐벼)	붐비니
붓다	부어	부으니	붓는
붓다	부어	부으니	붓는
붓다	붓는
붕붕거리다	붕붕거리어(붕붕거려)	붕붕거리니
붙다	붙어	붙으니	붙는
붙들다	붙들어	붙드니	붙드오
붙들리다	붙들리어(붙들려)	붙들리니
붙박이다	붙박이어(붙박여)	붙박이니
붙어다니다	붙어다니어	붙어다녀	붙어다니니
붙어살다	붙어살아	붙어사니	붙어사오
붙이다	붙이어(붙여)	붙이니
붙잡히다	붙잡히어(붙잡혀)	붙잡히니
비다	비어(벼)	비니
비기다	비기어(비겨)	비기니
비기다	비기어(비겨)	비기니
비기다	비기어(비겨)	비기니
비기다	비기어(비겨)	비기니
비껴가다	비껴가	비껴가니
비껴들다	비껴들어	비껴드니	비껴드오
비껴들다	비껴들어	비껴드니	비껴드오
비꼬다	비꼬아(비꽈)	비꼬니
비꼬이다	비꼬이어(비꼬여)	비꼬이니
비꾸러지다	비꾸러지어(비꾸러져)	비꾸러지니
비끄러매다	비끄러매어(비끄러매)	비끄러매니
비끼다	비끼어(비껴)	비끼니
비대다	비대어(비대)	비대니
비뚤어지다	비뚤어지어(비뚤어져)	비뚤어지니
비비다	비비어(비벼)	비비니
비비대다	비비대어(비비대)	비비대니
비비적거리다	비비적거리어(비비적거려)	비비적거리니
비슬거리다	비슬거리어(비슬거려)	비슬거리니
비실거리다	비실거리어(비실거려)	비실거리니
비실대다	비실대어(비실대)	비실대니
비아냥거리다	비아냥거리어(비아냥거려)	비아냥거리니
비아냥대다	비아냥대어(비아냥대)	비아냥대니
비어져나오다	비어져나와	비어져나오니
비어지다	비어지어(비어져)	비어지니
비우다	비우어(비워)	비우니
비져나오다	비져나와	비져나오니
비죽거리다	비죽거리어(비죽거려)	비죽거리니
비쭉거리다	비쭉거리어(비쭉거려)	비쭉거리니
비쭉이다	비쭉이어(비쭉여)	비쭉이니
비척거리다	비척거리어(비척거려)	비척거리니
비추다	비추어(비춰)	비추니
비추이다	비추이어(비추여)	비추이니
비치다	비치어(비쳐)	비치니
비칠거리다	비칠거리어(비칠거려)	비칠거리니
비켜나다	비켜나	비켜나니
비켜서다	비켜서	비켜서니
비키다	비키어(비켜)	비키니
비틀다	비틀어	비트니	비트오
비틀거리다	비틀거리어(비틀거려)	비틀거리니
비틀리다	비틀리어(비틀려)	비틀리니
비틀어지다	비틀어지어(비틀어져)	비틀어지니
빈둥거리다	빈둥거리어(빈둥거려)	빈둥거리니
빈정거리다	빈정거리어(빈정거려)	빈정거리니
빈정대다	빈정대어(빈정대)	빈정대니
빌다	빌어	비니	비오
빌다	빌어	비니	비오
빌려주다	빌려주어(빌려줘)	빌려주니
빌려주다	빌려주어(빌려줘)	빌려주니
빌려주다	빌려주어(빌려줘)	빌려주니
빌리다	빌리어(빌려)	빌리니
빌빌대다	빌빌대어(빌빌대)	빌빌대니
빗기다	빗기어	빗겨	빗기니
빗기다	빗기어(빗겨)	빗기니
빗나가다	빗나가	빗나가니
빗대다	빗대어(빗대)	빗대니
빗발치다	빗발치어(빗발쳐)	빗발치니
빗보다	빗보아(빗봐)	빗보니
빙글거리다	빙글거리어(빙글거려)	빙글거리니
빙긋거리다	빙긋거리어(빙긋거려)	빙긋거리니
빚내다	빚내어(빚내)	빚내니
빚어내다	빚어내어(빚어내)	빚어내니
빚어지다	빚어지어(빚어져)	빚어지니
빚지다	빚지어(빚져)	빚지니
빛나다	빛나	빛나니
빛내다	빛내어(빛내)	빛내니
빠개다	빠개어(빠개)	빠개니
빠개지다	빠개지어(빠개져)	빠개지니
빠뜨리다	빠뜨리어(빠뜨려)	빠뜨리니
빠져나가다	빠져나가	빠져나가니
빠져나오다	빠져나와	빠져나오니
빠져들다	빠져들어	빠져드니	빠져드오
빠져들어가다	빠져들어가	빠져들어가니
빠지다	빠지어(빠져)	빠지니
빠지다	빠지어(빠져)	빠지니
빠트리다	빠트리어(빠트려)	빠트리니
빤들거리다	빤들거리어(빤들거려)	빤들거리니
빤들거리다	빤들거리어(빤들거려)	빤들거리니
빤짝거리다	빤짝거리어(빤짝거려)	빤짝거리니
빨다	빨아	빠니	빠오
빨다	빨아	빠니	빠오
빨다	빨아	빠니	빠오
빨개지다	빨개지어(빨개져)	빨개지니
빨라지다	빨라지어	빨라져	빨라지니
빨려들다	빨려들어	빨려드니
빨리다	빨리어	빨려	빨리니
빨리다	빨리어(빨려)	빨리니
빨리다	빨리어(빨려)	빨리니
빨리다	빨리어(빨려)	빨리니
빨아내다	빨아내어(빨아내)	빨아내니
빨아당기다	빨아당기어	빨아당겨	빨아당기니
빨아들이다	빨아들이어(빨아들여)	빨아들이니
빨아올리다	빨아올리어(빨아올려)	빨아올리니
빼다	빼어(빼)	빼니
빼다	빼어(빼)	빼니
빼다	빼어(빼)	빼니
빼다	빼어	빼	빼니
빼내다	빼내어(빼내)	빼내니
빼놓다	빼놓아(빼놔)	빼놓으니	빼놓는	빼놓소
빼돌리다	빼돌리어(빼돌려)	빼돌리니
빼먹다	빼먹어	빼먹으니	빼먹는
빼앗기다	빼앗기어(빼앗겨)	빼앗기니
빼치다	빼치어(빼쳐)	빼치니
빽빽거리다	빽빽거리어(빽빽거려)	빽빽거리니
뺀질거리다	뺀질거리어(뺀질거려)	뺀질거리니
뺏다	뺏어	뺏으니	뺏는
뺏기다	뺏기어(뺏겨)	뺏기니
뺑소니치다	뺑소니치어(뺑소니쳐)	뺑소니치니
뺨치다	뺨치어(뺨쳐)	뺨치니
뻐개지다	뻐개지어	뻐개져	뻐개지니
뻐기다	뻐기어(뻐겨)	뻐기니
뻐기다	뻐기어(뻐겨)	뻐기니
뻐끔거리다	뻐끔거리어(뻐끔거려)	뻐끔거리니
뻐드러지다	뻐드러지어(뻐드러져)	뻐드러지니
뻗대다	뻗대어(뻗대)	뻗대니
뻗어오르다	뻗어올라	뻗어오르니
뻗치다	뻗치어(뻗쳐)	뻗치니
뻗히다	뻗히어(뻗혀)	뻗히니
뻥치다	뻥치어(뻥쳐)	뻥치니
뽐내다	뽐내어(뽐내)	뽐내니
뽑다	뽑아	뽑으니	뽑는
뽑아내다	뽑아내어(뽑아내)	뽑아내니
뽑아올리다	뽑아올리어	뽑아올려	뽑아올리니
뽑히다	뽑히어(뽑혀)	뽑히니
뿅가다	뿅가	뿅가니
뿌리다	뿌리어(뿌려)	뿌리니
뿌리내리다	뿌리내리어(뿌리내려)	뿌리내리니
뿌리박히다	뿌리박히어(뿌리박혀)	뿌리박히니
뿌리치다	뿌리치어(뿌리쳐)	뿌리치니
뿔나다	뿔나	뿔나니
뿜어내다	뿜어내어(뿜어내)	뿜어내니
삐다	삐어(뼈)	삐니
삐다	삐어(뼈)	삐니
삐걱거리다	삐걱거리어(삐걱거려)	삐걱거리니
삐그덕거리다	삐그덕거리어(삐그덕거려)	삐그덕거리니
삐그덕거리다	삐그덕거리어(삐그덕거려)	삐그덕거리니
삐뚤어지다	삐뚤어지어(삐뚤어져)	삐뚤어지니
삐어져나오다	삐어져나와	삐어져나오니
삐어지다	삐어지어	삐어져	삐어지니
삐용거리다	삐용거리어	삐용거려	삐용거리니
삐져나오다	삐져나와	삐져나오니
삐죽거리다	삐죽거리어(삐죽거려)	삐죽거리니
삐죽이다	삐죽이어(삐죽여)	삐죽이니
삐지다	삐지어(삐져)	삐지니
삐지다	삐지어(삐져)	삐지니
삐지다	삐지어	삐져	삐지니
삐쭉거리다	삐쭉거리어(삐쭉거려)	삐쭉거리니
삐쭉대다	삐쭉대어(삐쭉대)	삐쭉대니
삐치다	삐치어(삐쳐)	삐치니
삐치다	삐치어(삐쳐)	삐치니
삐치다	삐치어(삐쳐)	삐치니
사다	사	사니
사각거리다	사각거리어(사각거려)	사각거리니
사고팔다	사고팔아	사고파니	사고파오
사과드리다	사과드리어(사과드려)	사과드리니
사귀다	사귀어	사귀니
사그라들다	사그라들어	사그라드니	사그라드오
사그라뜨리다	사그라뜨리어(사그라뜨려)	사그라뜨리니
사그라지다	사그라지어(사그라져)	사그라지니
사기치다	사기치어	사기쳐	사기치니
사나워지다	사나워지어(사나워져)	사나워지니
사들이다	사들이어(사들여)	사들이니
사라지다	사라지어(사라져)	사라지니
사로자다	사로자	사로자니
사로잡히다	사로잡히어(사로잡혀)	사로잡히니
사뢰다	사뢰어(사뢔)	사뢰니
사리다	사리어(사려)	사리니
사무치다	사무치어(사무쳐)	사무치니
사위다	사위어	사위니
삭이다	삭이어(삭여)	삭이니
삭이다	삭이어(삭여)	삭이니
삭히다	삭히어(삭혀)	삭히니
산들거리다	산들거리어(산들거려)	산들거리니
살다	살아	사니	사오
살다	살아	사니	사오
살랑거리다	살랑거리어(살랑거려)	살랑거리니
살랑거리다	살랑거리어(살랑거려)	살랑거리니
살랑이다	살랑이어(살랑여)	살랑이니
살리다	살리어(살려)	살리니
살살거리다	살살거리어(살살거려)	살살거리니
살살거리다	살살거리어(살살거려)	살살거리니
살아가다	살아가	살아가니
살아나다	살아나	살아나니
살아오다	살아와	살아오니
살인나다	살인나	살인나니
살찌다	살찌어(살쪄)	살찌니
살찌우다	살찌우어(살찌워)	살찌우니
살판나다	살판나	살판나니
살펴보다	살펴보아(살펴봐)	살펴보니
살피다	살피어(살펴)	살피니
살피다	살피어(살펴)	살피니
삶다	삶아	삶으니	삶고	삶는	삶지
삼다	삼아	삼으니
삼다	삼아	삼으니
삼가다	삼가	삼가니
삼키다	삼키어(삼켜)	삼키니
상우다	상우어(상워)	상우니
새다	새어(새)	새니
새다	새어(새)	새니
새겨듣다	새겨들어	새겨들으니	새겨듣는
새겨보다	새겨보아(새겨봐)	새겨보니
새기다	새기어(새겨)	새기니
새기다	새기어(새겨)	새기니
새기다	새기어(새겨)	새기니
새까매지다	새까매지어(새까매져)	새까매지니
새롭다	새로워	새로우니
새빨개지다	새빨개지어(새빨개져)	새빨개지니
새우다	새우어(새워)	새우니
새우다	새우어(새워)	새우니
새카매지다	새카매지어(새카매져)	새카매지니
새큰거리다	새큰거리어(새큰거려)	새큰거리니
새파래지다	새파래지어(새파래져)	새파래지니
새하얘지다	새하얘지어(새하얘져)	새하얘지니
샐쭉거리다	샐쭉거리어(샐쭉거려)	샐쭉거리니
샛노래지다	샛노래지어(샛노래져)	샛노래지니
생각나다	생각나	생각나니
생겨나다	생겨나	생겨나니
생글거리다	생글거리어(생글거려)	생글거리니
생기다	생기어(생겨)	생기니
생색내다	생색내어(생색내)	생색내니
서다	서	서니
서걱거리다	서걱거리어(서걱거려)	서걱거리니
서글퍼지다	서글퍼지어(서글퍼져)	서글퍼지니
서두르다	서둘러	서두르니
서둘다	서두니
서리다	서리어(서려)	서리니
서리다	서리어(서려)	서리니
서성거리다	서성거리어(서성거려)	서성거리니
서성대다	서성대어(서성대)	서성대니
서성이다	서성이어(서성여)	서성이니
섞다	섞어	섞으니	섞는
섞이다	섞이어(섞여)	섞이니
선보다	선보아(선봐)	선보니
선보이다	선보이어(선보여)	선보이니
선뵈다	선뵈어(선봬)	선뵈니
섣부르다	섣불러	섣부르니
설렁거리다	설렁거리어(설렁거려)	설렁거리니
설레다	설레어(설레)	설레니
설익히다	설익히어(설익혀)	설익히니
설치다	설치어(설쳐)	설치니
설치다	설치어(설쳐)	설치니
섬기다	섬기어(섬겨)	섬기니
성가시다	성가시어(성가셔)	성가시니
성나다	성나	성나니
성내다	성내어(성내)	성내니
성질나다	성질나	성질나니
세다	세어(세)	세니
세다	세어(세)	세니
세다	세어(세)	세니
세내다	세내어(세내)	세내니
세련되다	세련되어(세련돼)	세련되니
세어지다	세어지어(세어져)	세어지니
세우다	세우어(세워)	세우니
세주다	세주어(세줘)	세주니
세주다	세주어(세줘)	세주니
세지다	세지어(세져)	세지니
소곤거리다	소곤거리어(소곤거려)	소곤거리니
소곤대다	소곤대어(소곤대)	소곤대니
소리치다	소리치어(소리쳐)	소리치니
소문나다	소문나	소문나니
소문내다	소문내어(소문내)	소문내니
소스라지다	소스라지어(소스라져)	소스라지니
소스라치다	소스라치어(소스라쳐)	소스라치니
소용돌이치다	소용돌이치어(소용돌이쳐)	소용돌이치니
속닥거리다	속닥거리어(속닥거려)	속닥거리니
속삭이다	속삭이어(속삭여)	속삭이니
속살거리다	속살거리어(속살거려)	속살거리니
속아넘어가다	속아넘어가	속아넘어가니
속여넘기다	속여넘기어	속여넘겨	속여넘기니
속이다	속이어(속여)	속이니
손꼽히다	손꼽히어(손꼽혀)	손꼽히니
손대다	손대어(손대)	손대니
손들다	손들어	손드니	손드오
손보다	손보아(손봐)	손보니
손보다	손보아(손봐)	손보니
손쓰다	손써	손쓰니
손잡다	손잡아	손잡으니	손잡는
손치다	손치어(손쳐)	손치니
손치다	손치어(손쳐)	손치니
손해나다	손해나	손해나니
솟구치다	솟구치어(솟구쳐)	솟구치니
솟아나다	솟아나	솟아나니
솟아오르다	솟아올라	솟아오르니
쇠다	쇠어(쇄)	쇠니
쇠다	쇠어(쇄)	쇠니
수군거리다	수군거리어(수군거려)	수군거리니
수군대다	수군대어(수군대)	수군대니
수그러들다	수그러들어	수그러드니	수그러드오
수그러지다	수그러지어(수그러져)	수그러지니
수그리다	수그리어(수그려)	수그리니
수런거리다	수런거리어(수런거려)	수런거리니
수선거리다	수선거리어(수선거려)	수선거리니
수틀리다	수틀리어(수틀려)	수틀리니
숙덕거리다	숙덕거리어(숙덕거려)	숙덕거리니
숙어지다	숙어지어(숙어져)	숙어지니
숙이다	숙이어(숙여)	숙이니
술렁거리다	술렁거리어(술렁거려)	술렁거리니
술렁대다	술렁대어(술렁대)	술렁대니
술렁이다	술렁이어(술렁여)	술렁이니
숨기다	숨기어(숨겨)	숨기니
숨넘어가다	숨넘어가	숨넘어가니
숨막히다	숨막히어	숨막혀	숨막히니
숨어들다	숨어들어	숨어드니	숨어드오
숨어살다	숨어살아	숨어사니
숨죽이다	숨죽이어(숨죽여)	숨죽이니
숨지다	숨지어(숨져)	숨지니
쉬다	쉬어	쉬니
쉬다	쉬어	쉬니
쉬다	쉬어	쉬니
쉬다	쉬어	쉬니
쉬다	쉬어	쉬니
쉬쉬거리다	쉬쉬거리어(쉬쉬거려)	쉬쉬거리니
쉬슬다	쉬슬어	쉬스니	쉬스오
쉬워지다	쉬워지어(쉬워져)	쉬워지니
쉬이다	쉬이어(쉬여)	쉬이니
스러지다	스러지어(스러져)	스러지니
스멀거리다	스멀거리어(스멀거려)	스멀거리니
스며들다	스며들어	스며드니	스며드오
스미다	스미어(스며)	스미니
스쳐가다	스쳐가	스쳐가니
스쳐보다	스쳐보아(스쳐봐)	스쳐보니
스쳐지나다	스쳐지나	스쳐지나니
스쳐지나가다	스쳐지나가	스쳐지나가니
스치다	스치어(스쳐)	스치니
슬다	슬어	스니	스오
슬다	슬어	스니	스오
슬다	슬어	스니	스오
슬다	슬어	스니	스오
슬퍼지다	슬퍼지어(슬퍼져)	슬퍼지니
슴벅거리다	슴벅거리어(슴벅거려)	슴벅거리니
시달리다	시달리어(시달려)	시달리니
시들다	시들어	시드니	시드오
시부렁대다	시부렁대어(시부렁대)	시부렁대니
시새우다	시새우어(시새워)	시새우니
시시덕거리다	시시덕거리어(시시덕거려)	시시덕거리니
시중들다	시중들어	시중드니	시중드오
시집가다	시집가	시집가니
시집보내다	시집보내어(시집보내)	시집보내니
시집오다	시집와	시집오니
시커메지다	시커메지어(시커메져)	시커메지니
시큰거리다	시큰거리어(시큰거려)	시큰거리니
시키다	시키어(시켜)	시키니
식식거리다	식식거리어(식식거려)	식식거리니
식히다	식히어(식혀)	식히니
신기다	신기어(신겨)	신기니
신나다	신나	신나니
신나다	신나	신나니
신들리다	신들리어(신들려)	신들리니
싣다	실어	실으니	싣는
실려가다	실려가	실려가니
실룩거리다	실룩거리어(실룩거려)	실룩거리니
실룩대다	실룩대어(실룩대)	실룩대니
실리다	실리어(실려)	실리니
실리다	실리어(실려)	실리니
실어나르다	실어날라	실어나르니
싫어지다	싫어지어(싫어져)	싫어지니
심다	심어	심으니
심기다	심기어	심겨	심기니
심해지다	심해지어	심해져	심해지니
싱글거리다	싱글거리어(싱글거려)	싱글거리니
싱글대다	싱글대어(싱글대)	싱글대니
싶다	싶어	싶으니
싸다	싸	싸니
싸다	싸	싸니
싸다	싸	싸니
싸다	싸	싸니
싸다	싸	싸니
싸갈기다	싸갈기어	싸갈겨	싸갈기니
싸고돌다	싸고돌아	싸고도니	싸고도오
싸다니다	싸다니어(싸다녀)	싸다니니
싸돌다	싸돌아	싸도니	싸도오
싸돌아다니다	싸돌아다니어(싸돌아다녀)	싸돌아다니니
싸매다	싸매어(싸매)	싸매니
싸우다	싸우어(싸워)	싸우니
싸이다	싸이어(싸여)	싸이니
싸이다	싸이어(싸여)	싸이니
싸잡히다	싸잡히어(싸잡혀)	싸잡히니
싸쥐다	싸쥐어	싸쥐니
싸지르다	싸질러	싸지르니
싸지르다	싸질러	싸지르니
싸지르다	싸질러	싸지르니
싹트다	싹터	싹트니
쌓다	쌓아	쌓으니	쌓는	쌓소
쌓아올리다	쌓아올리어	쌓아올려	쌓아올리니
쌓이다	쌓이어(쌓여)	쌓이니
쌔다	쌔어	쌔니
쌔다	쌔어(쌔)	쌔니
쌔다	쌔어	쌔	쌔니
쌔비다	쌔비어(쌔벼)	쌔비니
써다	써	써니
써내다	써내어(써내)	써내니
써붙이다	써붙이어	써붙여	써붙이니
써지다	써지어(써져)	써지니
썩이다	썩이어(썩여)	썩이니
썩히다	썩히어(썩혀)	썩히니
썰다	썰어	써니	써오
썰다	썰어	써니	써오
썰리다	썰리어	썰려	썰리니
썰리다	썰리어	썰려	썰리니
썰리다	썰리어(썰려)	썰리니
썰리다	썰리어(썰려)	썰리니
쏘다	쏘아(쏴)	쏘니
쏘다니다	쏘다니어(쏘다녀)	쏘다니니
쏘아보다	쏘아보아(쏘아봐)	쏘아보니
쏘아붙이다	쏘아붙이어(쏘아붙여)	쏘아붙이니
쏘이다	쏘이어(쏘여)	쏘이니
쏘이다	쏘이어	쏘여	쏘이니
쏘이다	쏘이어	쏘여	쏘이니
쏘이다	쏘이어(쏘여)	쏘이니
쏟다	쏟아	쏟으니	쏟는
쏟아붓다	쏟아부어	쏟아부으니	쏟아붓는
쏟아지다	쏟아지어(쏟아져)	쏟아지니
쏠다	쏠아	쏘니	쏘오
쏠리다	쏠리어(쏠려)	쏠리니
쐬다	쐬어(쐐)	쐬니
쐬다	쐬어(쐐)	쐬니
쑤다	쑤어(쒀)	쑤니
쑤군거리다	쑤군거리어(쑤군거려)	쑤군거리니
쑤석거리다	쑤석거리어(쑤석거려)	쑤석거리니
쑤시다	쑤시어(쑤셔)	쑤시니
쑤시다	쑤시어(쑤셔)	쑤시니
쑥덕거리다	쑥덕거리어(쑥덕거려)	쑥덕거리니
쑥덕대다	쑥덕대어(쑥덕대)	쑥덕대니
쑥덕이다	쑥덕이어(쑥덕여)	쑥덕이니
쓰다	써	쓰니
쓰다	써	쓰니
쓰다	써	쓰니
쓰다	써	쓰니
쓰다	써	쓰니
쓰러뜨리다	쓰러뜨리어(쓰러뜨려)	쓰러뜨리니
쓰러지다	쓰러지어(쓰러져)	쓰러지니
쓰이다	쓰이어	쓰여	쓰이니
쓰이다	쓰이어	쓰여	쓰이니
쓰이다	쓰이어	쓰여	쓰이니
쓰이다	쓰이어	쓰여	쓰이니
쓸다	쓸어	쓰니	쓰오
쓸다	쓸어	쓰니	쓰오
쓸리다	쓸리어(쓸려)	쓸리니
쓸리다	쓸리어(쓸려)	쓸리니
쓸리다	쓸리어	쓸려	쓸리니
쓸리다	쓸리어	쓸려	쓸리니
쓸리다	쓸리어(쓸려)	쓸리니
쓸어내리다	쓸어내리어(쓸어내려)	쓸어내리니
쓸어넘기다	쓸어넘기어	쓸어넘겨	쓸어넘기니
쓸어버리다	쓸어버리어(쓸어버려)	쓸어버리니
씀벅거리다	씀벅거리어(씀벅거려)	씀벅거리니
씌다	씌어	씌니
씌다	씌어	씌니
씌다	씌어	씌니
씌다	씌어	씌니
씌다	씌어	씌니
씌우다	씌우어(씌워)	씌우니
씌우다	씌워	씌우니
씨근거리다	씨근거리어(씨근거려)	씨근거리니
씨부렁거리다	씨부렁거리어(씨부렁거려)	씨부렁거리니
씩씩거리다	씩씩거리어(씩씩거려)	씩씩거리니
씰룩거리다	씰룩거리어(씰룩거려)	씰룩거리니
씰룩이다	씰룩이어(씰룩여)	씰룩이니
씹히다	씹히어(씹혀)	씹히니
씹히다	씹히어(씹혀)	씹히니
씻다	씻어	씻으니	씻는
씻기다	씻기어(씻겨)	씻기니
씻기다	씻기어(씻겨)	씻기니
씻부시다	씻부시어(씻부셔)	씻부시니
아깝다	아까워	아까우니
아끼다	아끼어(아껴)	아끼니
아니꼽다	아니꼬워	아니꼬우니
아로새기다	아로새기어(아로새겨)	아로새기니
아롱거리다	아롱거리어(아롱거려)	아롱거리니
아롱지다	아롱지어(아롱져)	아롱지니
아뢰다	아뢰어(아뢔)	아뢰니
아른거리다	아른거리어(아른거려)	아른거리니
아름다워지다	아름다워지어	아름다워져	아름다워지니
아물다	아물어	아무니	아무오
아물거리다	아물거리어(아물거려)	아물거리니
아쉽다	아쉬워	아쉬우니
아우러지다	아우러지어(아우러져)	아우러지니
아우르다	아울러	아우르니
아우성치다	아우성치어(아우성쳐)	아우성치니
아장거리다	아장거리어(아장거려)	아장거리니
악다물다	악다물어	악다무니	악다무오
악물다	악물어	악무니	악무오
악물리다	악물리어(악물려)	악물리니
악쓰다	악써	악쓰니
안기다	안기어	안겨	안기니
안기다	안기어	안겨	안기니
안기다	안기어(안겨)	안기니
안기다	안기어(안겨)	안기니
안되다	안되어(안돼)	안되니
안되다	안되어(안돼)	안되니
안치다	안치어(안쳐)	안치니
안치다	안치어(안쳐)	안치니
안타다	안타	안타니
안타깝다	안타까워	안타까우니
앉다	앉아	앉으니	앉고	앉는	앉지
앉히다	앉히어(앉혀)	앉히니
않다	않아	않으니	않는	않소
알다	알아	아니	아오
알려지다	알려지어(알려져)	알려지니
알리다	알리어(알려)	알리니
알아내다	알아내어(알아내)	알아내니
알아듣다	알아들어	알아들으니	알아듣는
알아맞히다	알아맞히어(알아맞혀)	알아맞히니
알아보다	알아보아(알아봐)	알아보니
알아주다	알아주어(알아줘)	알아주니
알아차리다	알아차리어(알아차려)	알아차리니
알아채다	알아채어(알아채)	알아채니
알짱거리다	알짱거리어(알짱거려)	알짱거리니
앓아눕다	앓아누워	앓아누우니	앓아눕는
앗아가다	앗아가	앗아가니
앙다물다	앙다물어	앙다무니	앙다무오
앞당기다	앞당기어(앞당겨)	앞당기니
앞두다	앞두어(앞둬)	앞두니
앞서다	앞서	앞서니
앞서가다	앞서가	앞서가니
앞서가다	앞서가	앞서가니
앞세우다	앞세우어(앞세워)	앞세우니
앞장서다	앞장서	앞장서니
앞장세우다	앞장세우어(앞장세워)	앞장세우니
앞지르다	앞질러	앞지르니
애먹이다	애먹이어(애먹여)	애먹이니
애쓰다	애써	애쓰니
애타다	애타	애타니
애태우다	애태우어(애태워)	애태우니
앵기다	앵기어(앵겨)	앵기니
앵돌아지다	앵돌아지어(앵돌아져)	앵돌아지니
앵앵거리다	앵앵거리어	앵앵거려	앵앵거리니
앵앵거리다	앵앵거리어	앵앵거려	앵앵거리니
앵앵거리다	앵앵거리어(앵앵거려)	앵앵거리니
야단나다	야단나	야단나니
야단치다	야단치어(야단쳐)	야단치니
야위다	야위어	야위니
약아빠지다	약아빠지어(약아빠져)	약아빠지니
얇아지다	얇아지어(얇아져)	얇아지니
얕보다	얕보아(얕봐)	얕보니
얕아지다	얕아지어(얕아져)	얕아지니
어그러뜨리다	어그러뜨리어(어그러뜨려)	어그러뜨리니
어그러지다	어그러지어(어그러져)	어그러지니
어긋나다	어긋나	어긋나니
어긋매끼다	어긋매끼어(어긋매껴)	어긋매끼니
어긋물리다	어긋물리어(어긋물려)	어긋물리니
어기다	어기어(어겨)	어기니
어두워지다	어두워지어	어두워져	어두워지니
어둡다	어두워	어두우니
어떻다	어때	어떠니	어떻소
어려워지다	어려워지어	어려워져	어려워지니
어렵다	어려워	어려우니
어루만지다	어루만지어(어루만져)	어루만지니
어룽거리다	어룽거리어(어룽거려)	어룽거리니
어룽지다	어룽지어(어룽져)	어룽지니
어르다	어르니	얼러
어르다	얼러	어르니
어른거리다	어른거리어(어른거려)	어른거리니
어름거리다	어름거리어(어름거려)	어름거리니
어리다	어리어(어려)	어리니
어리다	어리어(어려)	어리니
어리다	어리어(어려)	어리니
어물거리다	어물거리어(어물거려)	어물거리니
어물쩍거리다	어물쩍거리어(어물쩍거려)	어물쩍거리니
어석거리다	어석거리어(어석거려)	어석거리니
어슬렁거리다	어슬렁거리어(어슬렁거려)	어슬렁거리니
어슷썰다	어슷썰어	어슷써니
어슷썰다	어슷썰어	어슷써니	어슷써오
어우러지다	어우러지어(어우러져)	어우러지니
어우르다	어울러	어우르니
어울리다	어울리어(어울려)	어울리니
어정거리다	어정거리어(어정거려)	어정거리니
어정뜨다	어정떠	어정뜨니
어지러뜨리다	어지러뜨리어(어지러뜨려)	어지러뜨리니
어지러워지다	어지러워지어(어지러워져)	어지러워지니
어지럽히다	어지럽히어(어지럽혀)	어지럽히니
어지르다	어질러	어지르니
어질러지다	어질러지어(어질러져)	어질러지니
어쩌다	어째	어쩌니
어쩌다	어째	어쩌니
어찌되다	어찌되어	어찌돼	어찌되니
억누르다	억눌러	억누르니
억눌리다	억눌리어(억눌려)	억눌리니
억억거리다	억억거리어(억억거려)	억억거리니
얹다	얹어	얹으니	얹고	얹는	얹지
얹혀살다	얹혀살아	얹혀사니	얹혀사오
얹히다	얹히어(얹혀)	얹히니
얻어걸리다	얻어걸리어(얻어걸려)	얻어걸리니
얻어내다	얻어내어	얻어내	얻어내니
얻어듣다	얻어들어	얻어들으니	얻어듣는
얻어먹다	얻어먹어	얻어먹으니	얻어먹는
얻어터지다	얻어터지어(얻어터져)	얻어터지니
얼다	얼어	어니	어오
얼룩지다	얼룩지어(얼룩져)	얼룩지니
얼리다	얼리어(얼려)	얼리니
얼리다	얼리어(얼려)	얼리니
얼버무리다	얼버무리어(얼버무려)	얼버무리니
얼빠지다	얼빠지어(얼빠져)	얼빠지니
얼씬거리다	얼씬거리어(얼씬거려)	얼씬거리니
얼쩡거리다	얼쩡거리어(얼쩡거려)	얼쩡거리니
얼크러지다	얼크러지어(얼크러져)	얼크러지니
얽매다	얽매어(얽매)	얽매니
얽매이다	얽매이어(얽매여)	얽매이니
얽어매다	얽어매어(얽어매)	얽어매니
얽히다	얽히어(얽혀)	얽히니
얽히고설키다	얽히고설키어(얽히고설켜)	얽히고설키니
엄청나다	엄청나	엄청나니
업신여기다	업신여기어(업신여겨)	업신여기니
업히다	업히어	업혀	업히니
업히다	업히어(업혀)	업히니
업히다	업히어(업혀)	업히니
없애다	없애어(없애)	없애니
없어지다	없어지어(없어져)	없어지니
엇갈리다	엇갈리어(엇갈려)	엇갈리니
엇기대다	엇기대어(엇기대)	엇기대니
엇나가다	엇나가	엇나가니
엇물리다	엇물리어(엇물려)	엇물리니
엇바꾸다	엇바꾸어(엇바꿔)	엇바꾸니
엇비끼다	엇비끼어(엇비껴)	엇비끼니
엉겨들다	엉겨들어	엉겨드니	엉겨드오
엉그름지다	엉그름지어(엉그름져)	엉그름지니
엉금거리다	엉금거리어	엉금거려	엉금거리니
엉금거리다	엉금거리어(엉금거려)	엉금거리니
엉기다	엉기어(엉겨)	엉기니
엉기다	엉기어(엉겨)	엉기니
엉엉거리다	엉엉거리어(엉엉거려)	엉엉거리니
엉클다	엉클어	엉크니	엉크오
엉클어지다	엉클어지어(엉클어져)	엉클어지니
엉키다	엉키어(엉켜)	엉키니
엎누르다	엎눌러	엎누르니
엎드리다	엎드리어(엎드려)	엎드리니
엎디다	엎디어(엎뎌)	엎디니
엎어지다	엎어지어(엎어져)	엎어지니
엎지르다	엎질러	엎지르니
엎질러지다	엎질러지어(엎질러져)	엎질러지니
엎치다	엎치어(엎쳐)	엎치니
에돌리다	에돌리어(에돌려)	에돌리니
에두르다	에둘러	에두르니
에둘리다	에둘리어(에둘려)	에둘리니
에우다	에우어(에워)	에우니
에워싸다	에워싸	에워싸니
에워싸이다	에워싸이어(에워싸여)	에워싸이니
여겨보다	여겨보아(여겨봐)	여겨보니
여겨지다	여겨지어	여겨져	여겨지니
여기다	여기어(여겨)	여기니
여닫히다	여닫히어(여닫혀)	여닫히니
여물다	여물어	여무니	여무오
여미다	여미어(여며)	여미니
여위다	여위어	여위니
여의다	여의어	여의니
여쭈다	여쭈어(여쭤)	여쭈니
여쭈어보다	여쭈어보아(여쭈어봐)	여쭈어보니
여쭈어보다	여쭈어보아(여쭈어봐)	여쭈어보니
여쭤보다	여쭤보아(여쭤봐)	여쭤보니
여쭤보다	여쭤보아(여쭤봐)	여쭤보니
역성들다	역성들어	역성드니	역성드오
엮다	엮어	엮으니	엮는
엮이다	엮이어(엮여)	엮이니
연노랗다	연노래	연노라니	연노랗소
연잇다	연이어	연이으니	연잇는
열다	열어	여니	여오
열다	열어	여니	여오
열리다	열리어(열려)	열리니
열리다	열리어(열려)	열리니
열어젖뜨리다	열어젖뜨리어(열어젖뜨려)	열어젖뜨리니
열어젖히다	열어젖히어(열어젖혀)	열어젖히니
엷어지다	엷어지어(엷어져)	엷어지니
엿듣다	엿들어	엿들으니	엿듣는
엿보다	엿보아(엿봐)	엿보니
엿보이다	엿보이어(엿보여)	엿보이니
영글다	영글어	영그니	영그오
예뻐지다	예뻐지어(예뻐져)	예뻐지니
오다	와	오니
오가다	오가	오가니
오고가다	오고가	오고가니
오그라들다	오그라들어	오그라드니	오그라드오
오그라뜨리다	오그라뜨리어(오그라뜨려)	오그라뜨리니
오그라지다	오그라지어(오그라져)	오그라지니
오그리다	오그리어(오그려)	오그리니
오다니다	오다니어	오다녀	오다니니
오들거리다	오들거리어(오들거려)	오들거리니
오래가다	오래가	오래가니
오래되다	오래되어(오래돼)	오래되니
오르다	올라	오르니
오르내리다	오르내리어(오르내려)	오르내리니
오리다	오리어(오려)	오리니
오물거리다	오물거리어(오물거려)	오물거리니
오물거리다	오물거리어(오물거려)	오물거리니
오므라들다	오므라들어	오므라드니	오므라드오
오므라지다	오므라지어(오므라져)	오므라지니
오므리다	오므리어(오므려)	오므리니
오싹거리다	오싹거리어(오싹거려)	오싹거리니
옥죄다	옥죄어(옥좨)	옥죄니
옥죄이다	옥죄이어(옥죄여)	옥죄이니
올되다	올되어(올돼)	올되니
올되다	올되어(올돼)	올되니
올라가다	올라가	올라가니
올라서다	올라서	올라서니
올라오다	올라와	올라오니
올라타다	올라타	올라타니
올려놓다	올려놓아(올려놔)	올려놓으니	올려놓는	올려놓소
올려다보다	올려다보아(올려다봐)	올려다보니
올려보다	올려보아	올려봐	올려보니
올려붙이다	올려붙이어(올려붙여)	올려붙이니
올려세우다	올려세우어(올려세워)	올려세우니
올려치다	올려치어(올려쳐)	올려치니
올리다	올리어(올려)	올리니
옭아매다	옭아매어(옭아매)	옭아매니
옮겨가다	옮겨가	옮겨가니
옮겨다니다	옮겨다니어	옮겨다녀	옮겨다니니
옮겨오다	옮겨와	옮겨오니	옮겨오너라
옮기다	옮기어(옮겨)	옮기니
옮아가다	옮아가	옮아가니
옮아오다	옮아와	옮아오니
옴직거리다	옴직거리어(옴직거려)	옴직거리니
옴츠리다	옴츠리어(옴츠려)	옴츠리니
옴치다	옴치어(옴쳐)	옴치니
옹송그리다	옹송그리어(옹송그려)	옹송그리니
옹알거리다	옹알거리어(옹알거려)	옹알거리니
옹이지다	옹이지어	옹이져	옹이지니
와글거리다	와글거리어(와글거려)	와글거리니
와들거리다	와들거리어(와들거려)	와들거리니
왕왕거리다	왕왕거리어(왕왕거려)	왕왕거리니
외다	외어(왜)	외니
외다	외어(왜)	외니
외다	외어(왜)	외니
외떨어지다	외떨어지어(외떨어져)	외떨어지니
외오다	외와	외오니
외우다	외우어(외워)	외우니
외치다	외치어(외쳐)	외치니
외틀다	외틀어	외트니	외트오
요동치다	요동치어(요동쳐)	요동치니
요러다	요래	요러니
요절내다	요절내어(요절내)	요절내니
욕되다	욕되어(욕돼)	욕되니
욕보다	욕보아(욕봐)	욕보니
욕보이다	욕보이어(욕보여)	욕보이니
욕심나다	욕심나	욕심나니
욕심내다	욕심내어(욕심내)	욕심내니
용솟음치다	용솟음치어(용솟음쳐)	용솟음치니
용쓰다	용써	용쓰니
우거지다	우거지어(우거져)	우거지니
우그러뜨리다	우그러뜨리어(우그러뜨려)	우그러뜨리니
우그러지다	우그러지어(우그러져)	우그러지니
우그리다	우그리어(우그려)	우그리니
우글거리다	우글거리어(우글거려)	우글거리니
우글거리다	우글거리어(우글거려)	우글거리니
우기다	우기어(우겨)	우기니
우닐다	우닐어	우니니	우니오
우러나다	우러나	우러나니
우러나오다	우러나와	우러나오니
우러러보다	우러러보아(우러러봐)	우러러보니
우러르다	우러러	우러르니
우려내다	우려내어(우려내)	우려내니
우리다	우리어(우려)	우리니
우리다	우리어(우려)	우리니
우물거리다	우물거리어(우물거려)	우물거리니
우물거리다	우물거리어(우물거려)	우물거리니
우비다	우비어(우벼)	우비니
우쭐거리다	우쭐거리어(우쭐거려)	우쭐거리니
우쭐대다	우쭐대어(우쭐대)	우쭐대니
욱대기다	욱대기어(욱대겨)	욱대기니
욱신거리다	욱신거리어(욱신거려)	욱신거리니
울다	울어	우니	우오
울다	울어	우니	우오
울렁거리다	울렁거리어(울렁거려)	울렁거리니
울렁이다	울렁이어(울렁여)	울렁이니
울려오다	울려와	울려오니
울리다	울리어(울려)	울리니
울리다	울리어	울려	울리니
울먹거리다	울먹거리어(울먹거려)	울먹거리니
울먹이다	울먹이어(울먹여)	울먹이니
울컥거리다	울컥거리어(울컥거려)	울컥거리니
움씰거리다	움씰거리어(움씰거려)	움씰거리니
움지럭거리다	움지럭거리어(움지럭거려)	움지럭거리니
움직거리다	움직거리어(움직거려)	움직거리니
움직이다	움직이어(움직여)	움직이니
움찔거리다	움찔거리어(움찔거려)	움찔거리니
움찔거리다	움찔거리어(움찔거려)	움찔거리니
움츠러들다	움츠러들어	움츠러드니	움츠러드오
움츠러지다	움츠러지어(움츠러져)	움츠러지니
움츠리다	움츠리어(움츠려)	움츠리니
움치다	움치어(움쳐)	움치니
움켜잡히다	움켜잡히어(움켜잡혀)	움켜잡히니
움켜쥐다	움켜쥐어	움켜쥐니
움키다	움키어(움켜)	움키니
움트다	움터	움트니
웃다	웃어	웃으니	웃는
웃기다	웃기어(웃겨)	웃기니
웃돌다	웃돌아	웃도니	웃도오
웃어넘기다	웃어넘기어(웃어넘겨)	웃어넘기니
웃자라다	웃자라	웃자라니
웅성거리다	웅성거리어(웅성거려)	웅성거리니
웅얼거리다	웅얼거리어(웅얼거려)	웅얼거리니
웅웅거리다	웅웅거리어	웅웅거려	웅웅거리니
웅웅대다	웅웅대어	웅웅대	웅웅대니
웅크리다	웅크리어(웅크려)	웅크리니
원수지다	원수지어(원수져)	원수지니
윙윙거리다	윙윙거리어(윙윙거려)	윙윙거리니
윙윙대다	윙윙대어(윙윙대)	윙윙대니
으깨다	으깨어(으깨)	으깨니
으깨어지다	으깨어지어(으깨어져)	으깨어지니
으깨지다	으깨지어(으깨져)	으깨지니
으뜸가다	으뜸가	으뜸가니
으르대다	으르대어(으르대)	으르대니
으르딱딱이다	으르딱딱이어(으르딱딱여)	으르딱딱이니
으르렁거리다	으르렁거리어(으르렁거려)	으르렁거리니
으르렁대다	으르렁대어(으르렁대)	으르렁대니
으스대다	으스대어(으스대)	으스대니
으스러지다	으스러지어(으스러져)	으스러지니
으쓱거리다	으쓱거리어(으쓱거려)	으쓱거리니
윽박지르다	윽박질러	윽박지르니
을러대다	을러대어(을러대)	을러대니
읊조리다	읊조리어(읊조려)	읊조리니
응그리다	응그리어(응그려)	응그리니
응달지다	응달지어(응달져)	응달지니
응어리지다	응어리지어(응어리져)	응어리지니
의심나다	의심나	의심나니
이다	이어(여)	이니
이다	이어(여)	이니
이글거리다	이글거리어(이글거려)	이글거리니
이기다	이기어(이겨)	이기니
이기다	이기어(이겨)	이기니
이기죽거리다	이기죽거리어(이기죽거려)	이기죽거리니
이끌다	이끌어	이끄니	이끄오
이끌리다	이끌리어(이끌려)	이끌리니
이러다	이래	이러니
이루다	이루어(이뤄)	이루니
이루어지다	이루어지어(이루어져)	이루어지니
이뤄지다	이뤄지어	이뤄져	이뤄지니
이뤄지다	이뤄지어(이뤄져)	이뤄지니
이뤄지다	이뤄지어(이뤄져)	이뤄지니
이르다	이르러	이르니
이르다	일러	이르니
이르다	일러	이르니
이름나다	이름나	이름나니
이어지다	이어지어(이어져)	이어지니
이울다	이울어	이우니	이우오
이죽거리다	이죽거리어(이죽거려)	이죽거리니
이죽대다	이죽대어(이죽대)	이죽대니
이지러뜨리다	이지러뜨리어(이지러뜨려)	이지러뜨리니
이지러지다	이지러지어(이지러져)	이지러지니
익다	익어	익으니	익는
익다	익어	익으니
익히다	익히어(익혀)	익히니
익히다	익히어	익히니
일다	일어	이니	이오
일다	일어	이니	이오
일다	이니
일구다	일구어(일궈)	일구니
일그러뜨리다	일그러뜨리어(일그러뜨려)	일그러뜨리니
일그러지다	일그러지어(일그러져)	일그러지니
일그러트리다	일그러트리어(일그러트려)	일그러트리니
일그리다	일그리어	일그려	일그리니
일그리다	일그리어(일그려)	일그리니
일깨우다	일깨워	일깨우니
일깨우다	일깨우어(일깨워)	일깨우니
일깨우다	일깨우어(일깨워)	일깨우니
일나다	일나	일나니
일떠서다	일떠서	일떠서니
일러두다	일러두어(일러둬)	일러두니
일러바치다	일러바치어(일러바쳐)	일러바치니
일렁거리다	일렁거리어(일렁거려)	일렁거리니
일렁이다	일렁이어(일렁여)	일렁이니
일어나다	일어나	일어나니
일어서다	일어서	일어서니
일으키다	일으키어(일으켜)	일으키니
일컫다	일컬어	일컬으니	일컫는
읽다	읽어	읽으니	읽고	읽는	읽지
읽혀지다	읽혀지어	읽혀져	읽혀지니
읽히다	읽히어	읽혀	읽히니
읽히다	읽히어	읽혀	읽히니
읽히다	읽히어	읽혀	읽히니
읽히다	읽히어(읽혀)	읽히니
읽히다	읽히어(읽혀)	읽히니
잃어버리다	잃어버리어(잃어버려)	잃어버리니
입다	입어	입으니	입는
입히다	입히어(입혀)	입히니
잇다	이어	이으니	잇는
잇다	이어	이으니	잇는
잇다	이어	이으니
잇달다	잇달아	잇다니	잇다오
잇대다	잇대어(잇대)	잇대니
잇따르다	잇따라	잇따르니
있다	있어	있으니	있는
잉잉거리다	잉잉거리어(잉잉거려)	잉잉거리니
잉잉거리다	잉잉거리어(잉잉거려)	잉잉거리니
잉잉대다	잉잉대어(잉잉대)	잉잉대니
잉잉대다	잉잉대어(잉잉대)	잉잉대니
잊어버리다	잊어버리어(잊어버려)	잊어버리니
잊히다	잊히어(잊혀)	잊히니
자다	자	자니
자드락거리다	자드락거리어(자드락거려)	자드락거리니
자라다	자라	자라니
자라다	자라	자라니
자라나다	자라나	자라나니
자라오르다	자라올라	자라오르니
자르다	잘라	자르니
자르다	잘라	자르니
자빠뜨리다	자빠뜨리어(자빠뜨려)	자빠뜨리니
자빠지다	자빠지어(자빠져)	자빠지니
자시다	자시어(자셔)	자시니
자아내다	자아내어(자아내)	자아내니
자아올리다	자아올리어(자아올려)	자아올리니
자지러들다	자지러들어	자지러드니	자지러드오
자지러지다	자지러지어(자지러져)	자지러지니
자지러지다	자지러지어(자지러져)	자지러지니
작살나다	작살나	작살나니
작살나다	작살나	작살나니
작살내다	작살내어(작살내)	작살내니
작아지다	작아지어(작아져)	작아지니
잘나가다	잘나가	잘나가니
잘되다	잘되어(잘돼)	잘되니
잘리다	잘리어(잘려)	잘리니
잘리다	잘리어(잘려)	잘리니
잘못되다	잘못되어(잘못돼)	잘못되니
잘빠지다	잘빠지어(잘빠져)	잘빠지니
잘살다	잘살아	잘사니	잘사오
잘생기다	잘생기어(잘생겨)
잠그다	잠가	잠그니
잠그다	잠가	잠그니
잠그다	잠가	잠그니
잠기다	잠기어(잠겨)	잠기니
잠기다	잠기어(잠겨)	잠기니
잠들다	잠들어	잠드니	잠드오
잠자다	잠자	잠자니
잠재우다	잠재우어(잠재워)	잠재우니
잡다	잡아	잡으니	잡는
잡수다	잡수어(잡숴)	잡수니
잡수시다	잡수시어(잡수셔)	잡수시니
잡아가다	잡아가	잡아가니
잡아끌다	잡아끌어	잡아끄니	잡아끄오
잡아내다	잡아내어(잡아내)	잡아내니
잡아넣다	잡아넣어	잡아넣으니	잡아넣는	잡아넣소
잡아당기다	잡아당기어(잡아당겨)	잡아당기니
잡아들이다	잡아들이어(잡아들여)	잡아들이니
잡아떼다	잡아떼어(잡아떼)	잡아떼니
잡아매다	잡아매어(잡아매)	잡아매니
잡아먹히다	잡아먹히어(잡아먹혀)	잡아먹히니
잡아오다	잡아와	잡아오니	잡아오너라
잡아죽이다	잡아죽이어	잡아죽여	잡아죽이니
잡아채다	잡아채어(잡아채)	잡아채니
잡아타다	잡아타	잡아타니
잡치다	잡치어(잡쳐)	잡치니
잡혀가다	잡혀가	잡혀가니
잡히다	잡히어(잡혀)	잡히니
잡히다	잡히어(잡혀)	잡히니
잡히다	잡히어(잡혀)	잡히니
잣다	자아	자으니	잣는
잣다	자아	자으니	잣는
장가가다	장가가	장가가니
장가들다	장가들어	장가드니	장가드오
장가들이다	장가들이어(장가들여)	장가들이니
장가보내다	장가보내어(장가보내)	장가보내니
장난치다	장난치어(장난쳐)	장난치니
잦아들다	잦아들어	잦아드니	잦아드오
잦아지다	잦아지어(잦아져)	잦아지니
잦아지다	잦아지어(잦아져)	잦아지니
재다	재어(재)	재니
재다	재어(재)	재니
재다	재어(재)	재니
재다	재어(재)	재니
재다	재어(재)	재니
재롱떨다	재롱떨어	재롱떠니	재롱떠오
재미나다	재미나	재미나니
재우다	재우어(재워)	재우니
재우다	재우어(재워)	재우니
재우다	재우어(재워)	재우니
재우다	재워	재우니
재우다	재워	재우니
재우치다	재우치어(재우쳐)	재우치니
재잘거리다	재잘거리어(재잘거려)	재잘거리니
재재거리다	재재거리어(재재거려)	재재거리니
쟁이다	쟁이어(쟁여)	쟁이니
저러다	저래	저러니
저리다	저리어(저려)	저리니
저물다	저물어	저무니	저무오
저미다	저미어(저며)	저미니
저버리다	저버리어(저버려)	저버리니
저지르다	저질러	저지르니
적시다	적시어(적셔)	적시니
적어지다	적어지어(적어져)	적어지니
적히다	적히어	적혀	적히니
적히다	적히어(적혀)	적히니
절다	절어	저니	저오
절다	절어	저니	저오
절뚝거리다	절뚝거리어(절뚝거려)	절뚝거리니
절룩거리다	절룩거리어(절룩거려)	절룩거리니
절름거리다	절름거리어(절름거려)	절름거리니
절벅거리다	절벅거리어(절벅거려)	절벅거리니
절이다	절이어(절여)	절이니
절절매다	절절매어(절절매)	절절매니
젊어지다	젊어지어(젊어져)	젊어지니
점치다	점치어(점쳐)	점치니
접붙이다	접붙이어(접붙여)	접붙이니
접어놓다	접어놓아(접어놔)	접어놓으니	접어놓는	접어놓소
접어들다	접어들어	접어드니	접어드오
접질리다	접질리어(접질려)	접질리니
접히다	접히어(접혀)	접히니
젓다	저어	저으니	젓는
정들다	정들어	정드니	정드오
정들이다	정들이어(정들여)	정들이니
정떨어지다	정떨어지어(정떨어져)	정떨어지니
정분나다	정분나	정분나니
정붙이다	정붙이어(정붙여)	정붙이니
젖뜨리다	젖뜨리어(젖뜨려)	젖뜨리니
젖혀지다	젖혀지어(젖혀져)	젖혀지니
젖히다	젖히어(젖혀)	젖히니
젖히다	젖히어(젖혀)	젖히니
제기다	제기어(제겨)	제기니
제기다	제기어(제겨)	제기니
제기다	제기어(제겨)	제기니
제기다	제기어(제겨)	제기니
제쳐놓다	제쳐놓아	제쳐놔	제쳐놓으니
제쳐두다	제쳐두어	제쳐둬	제쳐두니
제치다	제치어(제쳐)	제치니
조각나다	조각나	조각나니
조르다	졸라	조르니
조르다	졸라	조르니
조리다	조리어(조려)	조리니
조리돌리다	조리돌리어(조리돌려)	조리돌리니
조바심치다	조바심치어(조바심쳐)	조바심치니
조아리다	조아리어(조아려)	조아리니
조여들다	조여들어	조여드니	조여드오
조이다	조이어(조여)	조이니
조잘거리다	조잘거리어(조잘거려)	조잘거리니
조지다	조지어(조져)	조지니
조지다	조지어(조져)	조지니
조지다	조지어(조져)	조지니
족대기다	족대기어(족대겨)	족대기니
족치다	족치어(족쳐)	족치니
졸다	졸아	조니	조오
졸다	졸아	조니	조오
졸라매다	졸라매어(졸라매)	졸라매니
졸리다	졸리어(졸려)	졸리니
졸리다	졸리어(졸려)	졸리니
졸리다	졸리어(졸려)	졸리니
졸아들다	졸아들어	졸아드니	졸아드오
졸이다	졸이어(졸여)	졸이니
좁아지다	좁아지어(좁아져)	좁아지니
좁아터지다	좁아터지어(좁아터져)	좁아터지니
좁히다	좁히어(좁혀)	좁히니
종결짓다	종결지어	종결지으니	종결짓는
종알거리다	종알거리어(종알거려)	종알거리니
좇아가다	좇아가	좇아가니
좇아오다	좇아와	좇아오니
좋다	좋아	좋으니	좋소
좋아지다	좋아지어	좋아져	좋아지니
죄다	죄어(좨)	죄니
죄어들다	죄어들어	죄어드니	죄어드오
죄이다	죄이어(죄여)	죄이니
죄짓다	죄지어	죄지으니	죄짓는
주다	주어(줘)	주니
주리다	주리어(주려)	주리니
주무르다	주물러	주무르니
주무시다	주무시어(주무셔)	주무시니
주물럭거리다	주물럭거리어(주물럭거려)	주물럭거리니
주물럭대다	주물럭대어(주물럭대)	주물럭대니
주물리다	주물리어(주물려)	주물리니
주물리다	주물리어(주물려)	주물리니
주섬거리다	주섬거리어(주섬거려)	주섬거리니
주섬거리다	주섬거리어(주섬거려)	주섬거리니
주어지다	주어지어(주어져)	주어지니
주억거리다	주억거리어(주억거려)	주억거리니
주워듣다	주워들어	주워들으니	주워듣는
주워섬기다	주워섬기어(주워섬겨)	주워섬기니
주저앉히다	주저앉히어(주저앉혀)	주저앉히니
주절거리다	주절거리어(주절거려)	주절거리니
주절대다	주절대어(주절대)	주절대니
주접떨다	주접떨어	주접떠니	주접떠오
주춤거리다	주춤거리어(주춤거려)	주춤거리니
죽다	죽어	죽으니	죽는
죽다	죽어	죽으니	죽는
죽어나다	죽어나	죽어나니
죽어지내다	죽어지내어(죽어지내)	죽어지내니
죽여주다	죽여주어(죽여줘)	죽여주니
죽이다	죽이어(죽여)	죽이니
죽이다	죽이어(죽여)	죽이니
죽치다	죽치어(죽쳐)	죽치니
줄다	줄어	주니	주오
줄달음치다	줄달음치어(줄달음쳐)	줄달음치니
줄어들다	줄어들어	줄어드니	줄어드오
줄어지다	줄어지어(줄어져)	줄어지니
줄이다	줄이어(줄여)	줄이니
줄행랑치다	줄행랑치어(줄행랑쳐)	줄행랑치니
줍다	주워	주우니	줍는
중얼거리다	중얼거리어(중얼거려)	중얼거리니
중얼대다	중얼대어(중얼대)	중얼대니
쥐다	쥐어	쥐니
쥐다	쥐어	쥐니
쥐어뜯기다	쥐어뜯기어(쥐어뜯겨)	쥐어뜯기니
쥐어박히다	쥐어박히어(쥐어박혀)	쥐어박히니
쥐어지르다	쥐어질러	쥐어지르니
쥐어짜다	쥐어짜	쥐어짜니
쥐이다	쥐이어	쥐여	쥐이니
쥐이다	쥐이어	쥐여	쥐이니
쥐이다	쥐이어(쥐여)	쥐이니
쥐이다	쥐이어(쥐여)	쥐이니
즐기다	즐기어(즐겨)	즐기니
지다	지어(져)	지니
지다	지어(져)	지니
지다	지어(져)	지니
지다	지어(져)	지니
지그리다	지그리어(지그려)	지그리니
지근거리다	지근거리어(지근거려)	지근거리니
지근거리다	지근거리어(지근거려)	지근거리니
지껄이다	지껄이어(지껄여)	지껄이니
지끈거리다	지끈거리어(지끈거려)	지끈거리니
지끈거리다	지끈거리어(지끈거려)	지끈거리니
지나다	지나	지나니
지나가다	지나가	지나가니
지나다니다	지나다니어(지나다녀)	지나다니니
지나오다	지나와	지나오니
지나치다	지나치어(지나쳐)	지나치니
지내다	지내어(지내)	지내니
지내보다	지내보아(지내봐)	지내보니
지니다	지니어(지녀)	지니니
지르다	질러	지르니
지르다	질러	지르니
지르다	질러	지르니
지릅뜨다	지릅떠	지릅뜨니
지분거리다	지분거리어(지분거려)	지분거리니
지분거리다	지분거리어(지분거려)	지분거리니
지분거리다	지분거리어(지분거려)	지분거리니
지새다	지새어(지새)	지새니
지새우다	지새우어(지새워)	지새우니
지어내다	지어내어(지어내)	지어내니
지우다	지우어(지워)	지우니
지우다	지우어(지워)	지우니
지음치다	지음치어(지음쳐)	지음치니
지저귀다	지저귀어	지저귀니
지절거리다	지절거리어(지절거려)	지절거리니
지절대다	지절대어(지절대)	지절대니
지지다	지지어(지져)	지지니
지질리다	지질리어(지질려)	지질리니
지치다	지치어(지쳐)	지치니
지치다	지치어(지쳐)	지치니
지치다	지치어(지쳐)	지치니
지치다	지치어(지쳐)	지치니
지켜보다	지켜보아(지켜봐)	지켜보니
지키다	지키어(지켜)	지키니
지피다	지피어(지펴)	지피니
지피다	지피어(지펴)	지피니
지피다	지피어(지펴)	지피니
진득거리다	진득거리어(진득거려)	진득거리니
진력나다	진력나	진력나니
질러가다	질러가	질러가니
질리다	질리어(질려)	질리니
질리다	질리어(질려)	질리니
질벅거리다	질벅거리어(질벅거려)	질벅거리니
질벅이다	질벅이어	질벅여	질벅이니
질척거리다	질척거리어(질척거려)	질척거리니
질퍽거리다	질퍽거리어(질퍽거려)	질퍽거리니
질퍽대다	질퍽대어(질퍽대)	질퍽대니
짊어지다	짊어지어(짊어져)	짊어지니
짊어지우다	짊어지우어(짊어지워)	짊어지우니
집어내다	집어내어(집어내)	집어내니
집어넣다	집어넣어	집어넣으니	집어넣는	집어넣소
집어던지다	집어던지어(집어던져)	집어던지니
집어삼키다	집어삼키어(집어삼켜)	집어삼키니
집어쓰다	집어써	집어쓰니
집어치우다	집어치우어(집어치워)	집어치우니
집어타다	집어타	집어타니
집적거리다	집적거리어(집적거려)	집적거리니
집적대다	집적대어(집적대)	집적대니
집히다	집히어(집혀)	집히니
짓다	지어	지으니	짓는
짓다	지어	지으니	짓는
짓다	지어	지으니	짓는
짓누르다	짓눌러	짓누르니
짓눌리다	짓눌리어(짓눌려)	짓눌리니
짓무르다	짓물러	짓무르니
짓뭉개다	짓뭉개어(짓뭉개)	짓뭉개니
짓밟히다	짓밟히어(짓밟혀)	짓밟히니
짓이기다	짓이기어(짓이겨)	짓이기니
징징거리다	징징거리어(징징거려)	징징거리니
징징대다	징징대어(징징대)	징징대니
짖다	짖어	짖으니	짖는
짙어지다	짙어지어(짙어져)	짙어지니
짚다	짚어	짚으니	짚는
짚이다	짚이어(짚여)	짚이니
짜다	짜	짜니
짜다	짜	짜니
짜다	짜	짜니
짜개다	짜개어(짜개)	짜개니
짜그라지다	짜그라지어(짜그라져)	짜그라지니
짜내다	짜내어(짜내)	짜내니
짜맞추다	짜맞추어	짜맞춰	짜맞추니
짜부라지다	짜부라지어(짜부라져)	짜부라지니
짜이다	짜이어	짜여	짜이니
짜이다	짜이어(짜여)	짜이니
짧아지다	짧아지어(짧아져)	짧아지니
짱박히다	짱박히어	짱박혀	짱박히니
짱박히다	짱박히어(짱박혀)	짱박히니
째다	째어(째)	째니
째다	째어(째)	째니
째다	째어	째니
째다	째어(째)	째니
째다	째어(째)	째니
째깍거리다	째깍거리어(째깍거려)	째깍거리니
째려보다	째려보아(째려봐)	째려보니
째지다	째지어(째져)	째지니
짹짹거리다	짹짹거리어(짹짹거려)	짹짹거리니
쨍쨍거리다	쨍쨍거리어(쨍쨍거려)	쨍쨍거리니
쩍쩍거리다	쩍쩍거리어(쩍쩍거려)	쩍쩍거리니
쩔다	쩔어	쩌니	쩌오
쩔쩔매다	쩔쩔매어(쩔쩔매)	쩔쩔매니
쩡쩡거리다	쩡쩡거리어(쩡쩡거려)	쩡쩡거리니
쪄내다	쪄내어(쪄내)	쪄내니
쪼다	쪼아(쫘)	쪼니
쪼개다	쪼개어(쪼개)	쪼개니
쪼개어지다	쪼개어지어(쪼개어져)	쪼개어지니
쪼개지다	쪼개지어(쪼개져)	쪼개지니
쪼그라들다	쪼그라들어	쪼그라드니	쪼그라드오
쪼그라지다	쪼그라지어(쪼그라져)	쪼그라지니
쪼그리다	쪼그리어(쪼그려)	쪼그리니
쪼들리다	쪼들리어(쪼들려)	쪼들리니
쪼이다	쪼이어(쪼여)	쪼이니
쪼이다	쪼이어(쪼여)	쪼이니
쪼이다	쪼이어(쪼여)	쪼이니
쪽찌다	쪽찌어	쪽쪄	쪽찌니
쪽팔리다	쪽팔리어(쪽팔려)	쪽팔리니
쫍치다	쫍치어(쫍쳐)	쫍치니
쫑그리다	쫑그리어(쫑그려)	쫑그리니
쫑긋거리다	쫑긋거리어(쫑긋거려)	쫑긋거리니
쫑알거리다	쫑알거리어(쫑알거려)	쫑알거리니
쫓다	쫓아	쫓으니	쫓는
쫓겨가다	쫓겨가	쫓겨가니
쫓겨나다	쫓겨나	쫓겨나니
쫓기다	쫓기어(쫓겨)	쫓기니
쫓아가다	쫓아가	쫓아가니
쫓아내다	쫓아내어(쫓아내)	쫓아내니
쫓아다니다	쫓아다니어(쫓아다녀)	쫓아다니니
쫓아오다	쫓아와	쫓아오니
쬐다	쬐어(쫴)	쬐니
쬐다	쬐어(쫴)	쬐니
쭈그러지다	쭈그러지어(쭈그러져)	쭈그러지니
쭈그리다	쭈그리어(쭈그려)	쭈그리니
쭈물대다	쭈물대어(쭈물대)	쭈물대니
쭈뼛거리다	쭈뼛거리어(쭈뼛거려)	쭈뼛거리니
쭈뼛대다	쭈뼛대어(쭈뼛대)	쭈뼛대니
찌다	찌어(쪄)	찌니
찌다	찌어(쪄)	찌니
찌다	찌어(쪄)	찌니
찌다	찌어(쪄)	찌니
찌다	찌어(쪄)	찌니
찌그러뜨리다	찌그러뜨리어(찌그러뜨려)	찌그러뜨리니
찌그러지다	찌그러지어(찌그러져)	찌그러지니
찌그리다	찌그리어(찌그려)	찌그리니
찌들다	찌들어	찌드니	찌드오
찌르다	찔러	찌르니
찌부러지다	찌부러지어(찌부러져)	찌부러지니
찌우다	찌우어(찌워)	찌우니
찌우다	찌우어(찌워)	찌우니
찌푸리다	찌푸리어(찌푸려)	찌푸리니
찍히다	찍히어	찍혀	찍히니
찍히다	찍히어(찍혀)	찍히니
찍히다	찍히어(찍혀)	찍히니
찔끔거리다	찔끔거리어(찔끔거려)	찔끔거리니
찔러바치다	찔러바치어	찔러바쳐	찔러바치니
찔러보다	찔러보아(찔러봐)	찔러보니
찔러주다	찔러주어(찔러줘)	찔러주니
찔리다	찔리어(찔려)	찔리니
찡그리다	찡그리어(찡그려)	찡그리니
찡기다	찡기어(찡겨)	찡기니
찢기다	찢기어	찢겨	찢기니
찢기다	찢기어	찢겨	찢기니
찢기다	찢기어(찢겨)	찢기니
찢기다	찢기어(찢겨)	찢기니
찢어발기다	찢어발기어(찢어발겨)	찢어발기니
찢어지다	찢어지어(찢어져)	찢어지니
찧다	찧어	찧으니	찧는	찧소
차다	차	차니
차다	차	차니
차다	차	차니
차다	차	차니
차가다	차가	차가니
차가워지다	차가워지어(차가워져)	차가워지니
차려놓다	차려놓아	차려놔	차려놓으니
차리다	차리어(차려)	차리니
차오르다	차올라	차오르니
차올리다	차올리어(차올려)	차올리니
차이다	차이어(차여)	차이니
차지다	차지어(차져)	차지니
찰랑거리다	찰랑거리어(찰랑거려)	찰랑거리니
찰랑거리다	찰랑거리어(찰랑거려)	찰랑거리니
찰싹거리다	찰싹거리어(찰싹거려)	찰싹거리니
참다	참아	참으니
찾다	찾아	찾으니	찾는
찾아가다	찾아가	찾아가니
찾아내다	찾아내어(찾아내)	찾아내니
찾아다니다	찾아다니어(찾아다녀)	찾아다니니
찾아들다	찾아들어	찾아드니	찾아드오
찾아보다	찾아보아(찾아봐)	찾아보니
찾아뵈다	찾아뵈어(찾아봬)	찾아뵈니
찾아오다	찾아와	찾아오니
채다	채어	채니
채다	채어(채)	채니
채다	채어(채)	채니
채다	채어(채)	채니
채우다	채우어(채워)	채우니
채우다	채우어(채워)	채우니
채우다	채우어(채워)	채우니
채우다	채우어(채워)	채우니
채이다	채이어	채여	채이니
채치다	채치어(채쳐)	채치니
채치다	채치어(채쳐)	채치니
채치다	채치어(채쳐)	채치니
책임지다	책임지어(책임져)	책임지니
책잡히다	책잡히어(책잡혀)	책잡히니
챙기다	챙기어(챙겨)	챙기니
처들이다	처들이어(처들여)	처들이니
처마시다	처마시어(처마셔)	처마시니
처매다	처매어(처매)	처매니
처먹이다	처먹이어(처먹여)	처먹이니
처바르다	처발라	처바르니
처바르다	처발라	처바르니
처바르다	처발라	처바르니
처바르다	처발라	처바르니
처박히다	처박히어(처박혀)	처박히니
처자빠지다	처자빠지어(처자빠져)	처자빠지니
처지다	처지어(처져)	처지니
처지르다	처질러	처지르니
천트다	천터	천트니
철그렁거리다	철그렁거리어(철그렁거려)	철그렁거리니
철나다	철나	철나니
철들다	철들어	철드니	철드오
철모르다	철몰라	철모르니
철버덕거리다	철버덕거리어(철버덕거려)	철버덕거리니
철썩이다	철썩이어(철썩여)	철썩이니
쳐가다	쳐가	쳐가니
쳐내다	쳐내어(쳐내)	쳐내니
쳐내다	쳐내어(쳐내)	쳐내니
쳐내려오다	쳐내려와	쳐내려오니	쳐내려오너라
쳐내려오다	쳐내려와	쳐내려오니
쳐다보다	쳐다보아(쳐다봐)	쳐다보니
쳐들다	쳐들어	쳐드니	쳐드오
쳐들리다	쳐들리어(쳐들려)	쳐들리니
쳐들어가다	쳐들어가	쳐들어가니
쳐들어오다	쳐들어와	쳐들어오니
쳐보다	쳐보아	쳐봐	쳐보니
쳐부수다	쳐부수어(쳐부숴)	쳐부수니
쳐올리다	쳐올리어(쳐올려)	쳐올리니
쳐주다	쳐주어(쳐줘)	쳐주니
쳐죽이다	쳐죽이어	쳐죽여	쳐죽이니
초상나다	초상나	초상나니
촐랑거리다	촐랑거리어(촐랑거려)	촐랑거리니
추다	추어(춰)	추니
추다	추어(춰)	추니
추근거리다	추근거리어(추근거려)	추근거리니
추근대다	추근대어(추근대)	추근대니
추리다	추리어(추려)	추리니
추스르다	추슬러	추스르니
추어올리다	추어올리어(추어올려)	추어올리니
추워지다	추워지어(추워져)	추워지니
추켜들다	추켜들어	추켜드니	추켜드오
추켜세우다	추켜세워	추켜세우니
추켜세우다	추켜세우어	추켜세우니
추켜올리다	추켜올리어	추켜올려	추켜올리니
추켜올리다	추켜올리어(추켜올려)	추켜올리니
추키다	추키어(추켜)	추키니
축나다	축나	축나니
축내다	축내어(축내)	축내니
축이다	축이어(축여)	축이니
출렁거리다	출렁거리어(출렁거려)	출렁거리니
출렁대다	출렁대어(출렁대)	출렁대니
출렁이다	출렁이어(출렁여)	출렁이니
춤추다	춤추어(춤춰)	춤추니
치다	치어(쳐)	치니
치다	치어(쳐)	치니
치다	치어(쳐)	치니
치다	치어(쳐)	치니
치다	치어(쳐)	치니
치근거리다	치근거리어(치근거려)	치근거리니
치근덕거리다	치근덕거리어(치근덕거려)	치근덕거리니
치근덕대다	치근덕대어(치근덕대)	치근덕대니
치닫다	치달아	치달으니	치닫는
치달리다	치달리어(치달려)	치달리니
치대다	치대어(치대)	치대니
치대다	치대어	치대	치대니
치대다	치대어(치대)	치대니
치대다	치대어(치대)	치대니
치뜨다	치떠	치뜨니
치르다	치러	치르니
치밀다	치밀어	치미니	치미오
치받치다	치받치어(치받쳐)	치받치니
치받치다	치받치어(치받쳐)	치받치니
치뻗치다	치뻗치어(치뻗쳐)	치뻗치니
치어다보다	치어다보아(치어다봐)	치어다보니
치오르다	치올라	치오르니
치올리다	치올리어(치올려)	치올리니
치우다	치우어(치워)	치우니
치우치다	치우치어(치우쳐)	치우치니
치이다	치이어(치여)	치이니
치이다	치이어	치여	치이니
치이다	치이어	치여	치이니
치이다	치이어	치여	치이니
치치다	치치어(치쳐)	치치니
치켜들다	치켜들어	치켜드니	치켜드오
치켜뜨다	치켜떠	치켜뜨니
치켜세우다	치켜세우어(치켜세워)	치켜세우니
치켜올리다	치켜올리어(치켜올려)	치켜올리니
치키다	치키어(치켜)	치키니
칩뜨다	칩떠	칩뜨니
칭얼거리다	칭얼거리어(칭얼거려)	칭얼거리니
칭얼대다	칭얼대어(칭얼대)	칭얼대니
캐다	캐어(캐)	캐니
캐내다	캐내어(캐내)	캐내니
캐묻다	캐물어	캐물으니	캐묻는
캐어묻다	캐어물어	캐어물으니	캐어묻는
캑캑거리다	캑캑거리어(캑캑거려)	캑캑거리니
커지다	커지어(커져)	커지니
켕기다	켕기어(켕겨)	켕기니
켜다	켜	켜니
켜다	켜	켜니
켜다	켜	켜니
켜다	켜	켜니
켜다	켜	켜니
켜지다	켜지어	켜져	켜지니
콜록거리다	콜록거리어(콜록거려)	콜록거리니
콩닥거리다	콩닥거리어(콩닥거려)	콩닥거리니
쿡쿡거리다	쿡쿡거리어(쿡쿡거려)	쿡쿡거리니
쿨럭거리다	쿨럭거리어(쿨럭거려)	쿨럭거리니
쿨렁거리다	쿨렁거리어(쿨렁거려)	쿨렁거리니
쿨룩거리다	쿨룩거리어(쿨룩거려)	쿨룩거리니
쿵쾅거리다	쿵쾅거리어(쿵쾅거려)	쿵쾅거리니
쿵쿵거리다	쿵쿵거리어(쿵쿵거려)	쿵쿵거리니
크다	커	크니
큰소리치다	큰소리치어(큰소리쳐)	큰소리치니
큰일나다	큰일나	큰일나니
큰코다치다	큰코다치어(큰코다쳐)	큰코다치니
킁킁거리다	킁킁거리어(킁킁거려)	킁킁거리니
킁킁대다	킁킁대어(킁킁대)	킁킁대니
키다	키어(켜)	키니
키드득거리다	키드득거리어(키드득거려)	키드득거리니
키득거리다	키득거리어(키득거려)	키득거리니
키들거리다	키들거리어(키들거려)	키들거리니
키우다	키우어(키워)	키우니
킥킥거리다	킥킥거리어(킥킥거려)	킥킥거리니
킥킥대다	킥킥대어(킥킥대)	킥킥대니
킬킬거리다	킬킬거리어(킬킬거려)	킬킬거리니
킬킬대다	킬킬대어(킬킬대)	킬킬대니
타다	타	타니
타다	타	타니
타다	타	타니
타다	타	타니
타다	타	타니
타고나다	타고나	타고나니
타내다	타내어(타내)	타내니
타시락거리다	타시락거리어(타시락거려)	타시락거리니
타오르다	타올라	타오르니
타이르다	타일러	타이르니
타지다	타지어(타져)	타지니
탐나다	탐나	탐나니
탐내다	탐내어(탐내)	탐내니
태나다	태나	태나니
태어나다	태어나	태어나니
태우다	태우어(태워)	태우니
태우다	태우어(태워)	태우니
태우다	태우어(태워)	태우니
태우다	태우어(태워)	태우니
태우다	태우어(태워)	태우니
터뜨리다	터뜨리어(터뜨려)	터뜨리니
터울거리다	터울거리어(터울거려)	터울거리니
터울대다	터울대어(터울대)	터울대니
터지다	터지어(터져)	터지니
터지다	터지어(터져)	터지니
터트리다	터트리어(터트려)	터트리니
털다	털어	터니	터오
털다	털어	터니	터오
털럭거리다	털럭거리어(털럭거려)	털럭거리니
털리다	털리어(털려)	털리니
털리다	털리어(털려)	털리니
털어놓다	털어놓아(털어놔)	털어놓으니	털어놓는	털어놓소
토끼다	토끼어(토껴)	토끼니
토닥거리다	토닥거리어(토닥거려)	토닥거리니
토닥이다	토닥이어(토닥여)	토닥이니
토라지다	토라지어(토라져)	토라지니
토라지다	토라지어(토라져)	토라지니
투기다	투기어	투겨	투기니
투덜거리다	투덜거리어(투덜거려)	투덜거리니
투덜대다	투덜대어(투덜대)	투덜대니
툴툴거리다	툴툴거리어(툴툴거려)	툴툴거리니
퉁겨지다	퉁겨지어(퉁겨져)	퉁겨지니
퉁기다	퉁기어(퉁겨)	퉁기니
퉁퉁거리다	퉁퉁거리어(퉁퉁거려)	퉁퉁거리니
퉁퉁대다	퉁퉁대어(퉁퉁대)	퉁퉁대니
튀다	튀어	튀니
튀기다	튀기어(튀겨)	튀기니
튀기다	튀기어(튀겨)	튀기니
튀어나오다	튀어나와	튀어나오니
튕기다	튕기어(튕겨)	튕기니
트다	터	트니
트다	터	트니
트이다	트이어(트여)	트이니
특징짓다	특징지어	특징지으니	특징짓는
틀다	틀어	트니	트오
틀리다	틀리어(틀려)	틀리니
틀리다	틀리어(틀려)	틀리니
틀어박히다	틀어박히어(틀어박혀)	틀어박히니
틀어쥐다	틀어쥐어	틀어쥐니
틀어지다	틀어지어(틀어져)	틀어지니
틈나다	틈나	틈나니
틈타다	틈타	틈타니
틔다	틔어	틔니
틔우다	틔우어(틔워)	틔우니
틔우다	틔우어(틔워)	틔우니
파다	파	파니
파고들다	파고들어	파고드니	파고드오
파나다	파나	파나니
파내다	파내어(파내)	파내니
파닥거리다	파닥거리어(파닥거려)	파닥거리니
파닥이다	파닥이어(파닥여)	파닥이니
파도치다	파도치어(파도쳐)	파도치니
파득거리다	파득거리어(파득거려)	파득거리니
파들거리다	파들거리어(파들거려)	파들거리니
파래지다	파래지어(파래져)	파래지니
파먹히다	파먹히어	파먹혀	파먹히니
파묻히다	파묻히어(파묻혀)	파묻히니
파이다	파이어(파여)	파이니
파헤치다	파헤치어(파헤쳐)	파헤치니
팔다	팔아	파니	파오
팔딱이다	팔딱이어(팔딱여)	팔딱이니
팔락거리다	팔락거리어(팔락거려)	팔락거리니
팔랑거리다	팔랑거리어(팔랑거려)	팔랑거리니
팔랑거리다	팔랑거리어(팔랑거려)	팔랑거리니
팔리다	팔리어(팔려)	팔리니
팔아넘기다	팔아넘기어(팔아넘겨)	팔아넘기니
패다	패어	패니
패다	패어(패)	패니
패다	패어(패)	패니
패다	패어(패)	패니
패다	패어(패)	패니
패대기치다	패대기치어(패대기쳐)	패대기치니
팽개치다	팽개치어(팽개쳐)	팽개치니
팽기다	팽기어(팽겨)	팽기니
퍼내다	퍼내어(퍼내)	퍼내니
퍼덕거리다	퍼덕거리어(퍼덕거려)	퍼덕거리니
퍼덕이다	퍼덕이어(퍼덕여)	퍼덕이니
퍼드러지다	퍼드러지어(퍼드러져)	퍼드러지니
퍼뜨리다	퍼뜨리어(퍼뜨려)	퍼뜨리니
퍼마시다	퍼마시어(퍼마셔)	퍼마시니
퍼먹이다	퍼먹이어	퍼먹여	퍼먹이니
퍼붓다	퍼부어	퍼부으니	퍼붓는
퍼지다	퍼지어(퍼져)	퍼지니
퍼지르다	퍼질러	퍼지르니
퍼지르다	퍼질러	퍼지르니
퍼지르다	퍼질러	퍼지르니
퍼지르다	퍼질러	퍼지르니
퍼트리다	퍼트리어(퍼트려)	퍼트리니
펄떡거리다	펄떡거리어(펄떡거려)	펄떡거리니
펄럭거리다	펄럭거리어(펄럭거려)	펄럭거리니
펄럭이다	펄럭이어(펄럭여)	펄럭이니
펄렁거리다	펄렁거리어(펄렁거려)	펄렁거리니
펄렁거리다	펄렁거리어(펄렁거려)	펄렁거리니
펴다	펴	펴니
펴내다	펴내어(펴내)	펴내니
펴놓다	펴놓아(펴놔)	펴놓으니	펴놓는	펴놓소
펴이다	펴이어(펴여)	펴이니
펴지다	펴지어(펴져)	펴지니
편들다	편들어	편드니	편드오
펼쳐지다	펼쳐지어(펼쳐져)	펼쳐지니
펼치다	펼치어(펼쳐)	펼치니
포개다	포개어(포개)	포개니
포개지다	포개지어(포개져)	포개지니
폴짝거리다	폴짝거리어(폴짝거려)	폴짝거리니
푸다	퍼	푸니
푸득거리다	푸득거리어(푸득거려)	푸득거리니
푸들거리다	푸들거리어(푸들거려)	푸들거리니
푸석거리다	푸석거리어(푸석거려)	푸석거리니
풀다	풀어	푸니	푸오
풀려나다	풀려나	풀려나니
풀려나가다	풀려나가	풀려나가니
풀려나오다	풀려나와	풀려나오니
풀리다	풀리어(풀려)	풀리니
풀리다	풀리어	풀려	풀리니
풀어내다	풀어내어(풀어내)	풀어내니
풀어놓다	풀어놓아(풀어놔)	풀어놓으니	풀어놓는	풀어놓소
풀어먹이다	풀어먹이어(풀어먹여)	풀어먹이니
풀어쓰다	풀어써	풀어쓰니
풀어지다	풀어지어(풀어져)	풀어지니
풀어헤치다	풀어헤치어(풀어헤쳐)	풀어헤치니
품기다	품기어(품겨)	품기니
풍기다	풍기어(풍겨)	풍기니
피다	피어(펴)	피니
피식거리다	피식거리어(피식거려)	피식거리니
피식거리다	피식거리어(피식거려)	피식거리니
피어나다	피어나	피어나니
피어오르다	피어올라	피어오르니
피우다	피우어(피워)	피우니
하다	하여(해)	하니
하느작거리다	하느작거리어(하느작거려)	하느작거리니
하늘거리다	하늘거리어(하늘거려)	하늘거리니
하늘대다	하늘대어(하늘대)	하늘대니
하얘지다	하얘지어(하얘져)	하얘지니
한눈팔다	한눈팔아	한눈파니	한눈파오
한물가다	한물가	한물가니
한숨짓다	한숨지어	한숨지으니	한숨짓는
할딱거리다	할딱거리어(할딱거려)	할딱거리니
할퀴다	할퀴어	할퀴니
합치다	합치어(합쳐)	합치니
해내다	해내어(해내)	해내니
해대다	해대어	해대	해대니
해뜨리다	해뜨리어(해뜨려)	해뜨리니
해롱대다	해롱대어(해롱대)	해롱대니
해보다	해보아(해봐)	해보니
해어지다	해어지어(해어져)	해어지니
해지다	해지어(해져)	해지니
해치다	해치어(해쳐)	해치니
해치우다	해치우어(해치워)	해치우니
허기지다	허기지어(허기져)	허기지니
허덕이다	허덕이어(허덕여)	허덕이니
허둥거리다	허둥거리어(허둥거려)	허둥거리니
허둥대다	허둥대어(허둥대)	허둥대니
허물다	허물어	허무니	허무오
허물다	허물어	허무니	허무오
허물어뜨리다	허물어뜨리어(허물어뜨려)	허물어뜨리니
허물어지다	허물어지어(허물어져)	허물어지니
허예지다	허예지어(허예져)	허예지니
허우적거리다	허우적거리어(허우적거려)	허우적거리니
허우적대다	허우적대어(허우적대)	허우적대니
허우적이다	허우적이어(허우적여)	허우적이니
허청거리다	허청거리어(허청거려)	허청거리니
허허대다	허허대어(허허대)	허허대니
헉헉거리다	헉헉거리어(헉헉거려)	헉헉거리니
헉헉대다	헉헉대어(헉헉대)	헉헉대니
헐다	헐어	허니	허오
헐다	헐어	허니	허오
헐다	헐어	허니	허오
헐떡거리다	헐떡거리어(헐떡거려)	헐떡거리니
헐떡이다	헐떡이어(헐떡여)	헐떡이니
헐리다	헐리어	헐려	헐리니
헐리다	헐리어	헐려	헐리니
헐리다	헐리어(헐려)	헐리니
헐리다	헐리어(헐려)	헐리니
헐어지다	헐어지어	헐어져	헐어지니
헐치다	헐치어(헐쳐)	헐치니
헛갈리다	헛갈리어(헛갈려)	헛갈리니
헛나가다	헛나가	헛나가니
헛놀리다	헛놀리어(헛놀려)	헛놀리니
헛놓이다	헛놓이어(헛놓여)	헛놓이니
헛돌다	헛돌아	헛도니	헛도오
헛듣다	헛들어	헛들으니	헛듣는
헛디디다	헛디디어(헛디뎌)	헛디디니
헛보다	헛보아(헛봐)	헛보니
헛보이다	헛보이어(헛보여)	헛보이니
헛살다	헛살아	헛사니	헛사오
헝클어뜨리다	헝클어뜨리어(헝클어뜨려)	헝클어뜨리니
헝클어지다	헝클어지어(헝클어져)	헝클어지니
헤대다	헤대어(헤대)	헤대니
헤매다	헤매어(헤매)	헤매니
헤벌리다	헤벌리어(헤벌려)	헤벌리니
헤벌어지다	헤벌어지어(헤벌어져)	헤벌어지니
헤아리다	헤아리어(헤아려)	헤아리니
헤어나다	헤어나	헤어나니
헤어지다	헤어지어(헤어져)	헤어지니
헤엄치다	헤엄치어(헤엄쳐)	헤엄치니
헤지다	헤지어(헤져)	헤지니
헤치다	헤치어(헤쳐)	헤치니
헤헤거리다	헤헤거리어(헤헤거려)	헤헤거리니
헥헥거리다	헥헥거리어(헥헥거려)	헥헥거리니
헷갈리다	헷갈리어(헷갈려)	헷갈리니
헹구다	헹구어(헹궈)	헹구니
호리다	호리어(호려)	호리니
호리다	호리어(호려)	호리니
호리다	호리어(호려)	호리니
호호거리다	호호거리어(호호거려)	호호거리니
호호거리다	호호거리어(호호거려)	호호거리니
혼나다	혼나	혼나니
혼내다	혼내어(혼내)	혼내니
혼쭐나다	혼쭐나	혼쭐나니
홀로되다	홀로되어(홀로돼)	홀로되니
홀리다	홀리어(홀려)	홀리니
홀짝거리다	홀짝거리어(홀짝거려)	홀짝거리니
홉뜨다	홉떠	홉뜨니
화끈거리다	화끈거리어(화끈거려)	화끈거리니
화나다	화나	화나니
화내다	화내어(화내)	화내니
홧홧거리다	홧홧거리어	홧홧거려	홧홧거리니
홧홧거리다	홧홧거리어(홧홧거려)	홧홧거리니
회오리치다	회오리치어(회오리쳐)	회오리치니
후끈거리다	후끈거리어(후끈거려)	후끈거리니
후드득거리다	후드득거리어(후드득거려)	후드득거리니
후들거리다	후들거리어(후들거려)	후들거리니
후들대다	후들대어(후들대)	후들대니
후려갈기다	후려갈기어(후려갈겨)	후려갈기니
후려내다	후려내어(후려내)	후려내니
후려치다	후려치어(후려쳐)	후려치니
후리다	후리어(후려)	후리니
후벼파다	후벼파	후벼파니
후비다	후비어(후벼)	후비니
훌닦이다	훌닦이어(훌닦여)	훌닦이니
훌뿌리다	훌뿌리어(훌뿌려)	훌뿌리니
훌쩍거리다	훌쩍거리어(훌쩍거려)	훌쩍거리니
훌쩍이다	훌쩍이어(훌쩍여)	훌쩍이니
훌치다	훌치어(훌쳐)	훌치니
훌치다	훌치어(훌쳐)	훌치니
훌치다	훌치어	훌쳐	훌치니
훑다	훑어	훑으니	훑고	훑는	훑지
훑어가다	훑어가	훑어가니
훑어내다	훑어내어	훑어내	훑어내니
훑어보다	훑어보아(훑어봐)	훑어보니
훑이다	훑이어(훑여)	훑이니
훔쳐가다	훔쳐가	훔쳐가니
훔쳐내다	훔쳐내어	훔쳐내	훔쳐내니
훔쳐내다	훔쳐내어	훔쳐내	훔쳐내니
훔쳐보다	훔쳐보아(훔쳐봐)	훔쳐보니
훔치다	훔치어(훔쳐)	훔치니
훔치다	훔치어(훔쳐)	훔치니
휘다	휘어	휘니
휘갈기다	휘갈기어(휘갈겨)	휘갈기니
휘감기다	휘감기어(휘감겨)	휘감기니
휘날리다	휘날리어(휘날려)	휘날리니
휘늘어지다	휘늘어지어(휘늘어져)	휘늘어지니
휘덮이다	휘덮이어(휘덮여)	휘덮이니
휘돌다	휘돌아	휘도니	휘도오
휘돌리다	휘돌리어(휘돌려)	휘돌리니
휘돌아보다	휘돌아보아(휘돌아봐)	휘돌아보니
휘두르다	휘둘러	휘두르니
휘두르다	휘둘러	휘두르니
휘둘러보다	휘둘러보아(휘둘러봐)	휘둘러보니
휘둘리다	휘둘리어(휘둘려)	휘둘리니
휘둥그레지다	휘둥그레지어(휘둥그레져)	휘둥그레지니
휘말리다	휘말리어(휘말려)	휘말리니
휘몰리다	휘몰리어(휘몰려)	휘몰리니
휘몰아치다	휘몰아치어(휘몰아쳐)	휘몰아치니
휘어지다	휘어지어(휘어져)	휘어지니
휘젓다	휘저어	휘저으니	휘젓는
휘청거리다	휘청거리어(휘청거려)	휘청거리니
휘청이다	휘청이어(휘청여)	휘청이니
휩싸다	휩싸	휩싸니
휩싸이다	휩싸이어(휩싸여)	휩싸이니
휩쓸다	휩쓸어	휩쓰니	휩쓰오
휩쓸리다	휩쓸리어(휩쓸려)	휩쓸리니
흉보다	흉보아(흉봐)	흉보니
흐느끼다	흐느끼어(흐느껴)	흐느끼니
흐느적거리다	흐느적거리어(흐느적거려)	흐느적거리니
흐느적이다	흐느적이어(흐느적여)	흐느적이니
흐드러지다	흐드러지어(흐드러져)	흐드러지니
흐려지다	흐려지어(흐려져)	흐려지니
흐르다	흘러	흐르니
흐르다	흘러	흐르니
흐르다	흘러	흐르니
흐리다	흐리어(흐려)	흐리니
흐리다	흐리어(흐려)	흐리니
흐리다	흐리어	흐려	흐리니
흐리다	흐리어	흐려	흐리니
흐무러지다	흐무러지어(흐무러져)	흐무러지니
흐물거리다	흐물거리어(흐물거려)	흐물거리니
흐물거리다	흐물거리어(흐물거려)	흐물거리니
흐트러뜨리다	흐트러뜨리어(흐트러뜨려)	흐트러뜨리니
흐트러지다	흐트러지어(흐트러져)	흐트러지니
흔들다	흔들어	흔드니	흔드오
흔들거리다	흔들거리어(흔들거려)	흔들거리니
흔들리다	흔들리어(흔들려)	흔들리니
흔들흔들거리다	흔들흔들거리어(흔들흔들거려)	흔들흔들거리니
흘겨보다	흘겨보아(흘겨봐)	흘겨보니
흘기다	흘기어(흘겨)	흘기니
흘끔거리다	흘끔거리어(흘끔거려)	흘끔거리니
흘끗거리다	흘끗거리어(흘끗거려)	흘끗거리니
흘러가다	흘러가	흘러가니
흘러나오다	흘러나와	흘러나오니
흘러내리다	흘러내리어(흘러내려)	흘러내리니
흘러넘치다	흘러넘치어(흘러넘쳐)	흘러넘치니
흘러들다	흘러들어	흘러드니	흘러드오
흘러오다	흘러와	흘러오니
흘려듣다	흘려들어	흘려들으니	흘려듣는
흘려버리다	흘려버리어(흘려버려)	흘려버리니
흘려버리다	흘려버리어(흘려버려)	흘려버리니
흘려보내다	흘려보내어(흘려보내)	흘려보내니
흘려주다	흘려주어(흘려줘)	흘려주니
흘리다	흘리어(흘려)	흘리니
흥얼거리다	흥얼거리어(흥얼거려)	흥얼거리니
흥청거리다	흥청거리어(흥청거려)	흥청거리니
흥청대다	흥청대어(흥청대)	흥청대니
흩날리다	흩날리어(흩날려)	흩날리니
흩뜨리다	흩뜨리어(흩뜨려)	흩뜨리니
흩뿌리다	흩뿌리어(흩뿌려)	흩뿌리니
흩어지다	흩어지어(흩어져)	흩어지니
흩트리다	흩트리어(흩트려)	흩트리니
희끗거리다	희끗거리어	희끗거려	희끗거리니
희끗거리다	희끗거리어(희끗거려)	희끗거리니
희끗거리다	희끗거리어(희끗거려)	희끗거리니
희번덕거리다	희번덕거리어(희번덕거려)	희번덕거리니
희번뜩대다	희번뜩대어	희번뜩대	희번뜩대니
히죽거리다	히죽거리어(히죽거려)	히죽거리니
히죽이다	히죽이어(히죽여)	히죽이니
히히거리다	히히거리어(히히거려)	히히거리니
힐끔거리다	힐끔거리어(힐끔거려)	힐끔거리니
힘내다	힘내어(힘내)	힘내니
힘들어지다	힘들어지어(힘들어져)	힘들어지니
힘들이다	힘들이어(힘들여)	힘들이니
힘쓰다	힘써	힘쓰니
힘주다	힘주어(힘줘)	힘주니
힝힝거리다	힝힝거리어(힝힝거려)	힝힝거리니
가깝다	가까워	가까우니
가냘프다	가냘파	가냘프니
가녀리다	가녀리어(가녀려)	가녀리니
가느다랗다	가느다래	가느다라니	가느다랗소
가늘다	가늘어	가느니	가느오
가득차다	가득차	가득차니
가렵다	가려워	가려우니
가물다	가물어	가무니	가무오
가볍다	가벼워	가벼우니
가쁘다	가빠	가쁘니
가소롭다	가소로워	가소로우니
가엽다	가여워	가여우니
가엾다	가엾어	가엾으니	가엾고	가엾지
가즈럽다	가즈러워	가즈러우니
가파르다	가팔라	가파르니
가팔막지다	가팔막지어	가팔막져	가팔막지니
가풀막지다	가풀막지어(가풀막져)	가풀막지니
각별나다	각별나	각별나니
간드러지다	간드러지어(간드러져)	간드러지니
간지럽다	간지러워	간지러우니
감미롭다	감미로워	감미로우니
감미롭다	감미로워	감미로우니
감사납다	감사나워	감사나우니
갑작스럽다	갑작스러워	갑작스러우니
값비싸다	값비싸	값비싸니
값싸다	값싸	값싸니
값지다	값지어(값져)	값지니
강파르다	강팔라	강파르니
강팔지다	강팔지어(강팔져)	강팔지니
같다	같아	같으니
개감스럽다	개감스러워	개감스러우니
개구지다	개구지어	개구져	개구지니
거북살스럽다	거북살스러워	거북살스러우니
거세다	거세어(거세)	거세니
거추장스럽다	거추장스러워	거추장스러우니
거칠다	거칠어	거치니	거치오
건방지다	건방지어(건방져)	건방지니
걸다	걸어	거니	거오
걸다	걸어	거니	거오
걸지다	걸지어	걸져	걸지니
걸지다	걸지어	걸져	걸지니
걸판지다	걸판지어(걸판져)	걸판지니
검누렇다	검누레	검누러니	검누렇소
검푸르다	검푸르러	검푸르니
게으르다	게을러	게으르니
게을러빠지다	게을러빠지어(게을러빠져)	게을러빠지니
게을러터지다	게을러터지어(게을러터져)	게을러터지니
겔러빠지다	겔러빠지어(겔러빠져)	겔러빠지니
겹다	겨워	겨우니
경사지다	경사지어(경사져)	경사지니
고달프다	고달파	고달프니
고되다	고되어(고돼)	고되니
고렇다	고래	고러니	고렇소
고르다	골라	고르니
고르다	골라	고르니
고르다	골라	고르니
고리다	고리어(고려)	고리니
고맙다	고마워	고마우니
고프다	고파	고프니
곧바르다	곧발라	곧바르니
곰살갑다	곰살가워	곰살가우니
곱다	고와	고우니
곱다	곱아	곱으니
곱다	곱아	곱으니
곱다	곱아	곱으니	곱는
곱다랗다	곱다래	곱다라니	곱다랗소
곱디곱다	곱디고와	곱디고우니
괴롭다	괴로워	괴로우니
구리다	구리어(구려)	구리니
구석지다	구석지어(구석져)	구석지니
구성지다	구성지어(구성져)	구성지니
구슬프다	구슬퍼	구슬프니
굳세다	굳세어(굳세)	굳세니
굴곡지다	굴곡지어(굴곡져)	굴곡지니
굵다랗다	굵다래	굵다라니	굵다랗소
굼뜨다	굼떠	굼뜨니
궁글다	궁글어	궁그니	궁그오
귀꿈스럽다	귀꿈스러워	귀꿈스러우니
귀엽다	귀여워	귀여우니
그렇다	그래	그러니	그렇소
그르다	글러	그르니
그르다	글러	그르니
그릇되다	그릇되어(그릇돼)	그릇되니
그립다	그리워	그리우니
근지럽다	근지러워	근지러우니
급작스럽다	급작스러워	급작스러우니
기껍다	기꺼워	기꺼우니
기다랗다	기다래	기다라니	기다랗소
기닿다	기대	기다니	기닿소
기똥차다	기똥차	기똥차니
기름지다	기름지어(기름져)	기름지니
기막히다	기막히어(기막혀)	기막히니
기쁘다	기뻐	기쁘니
기운차다	기운차	기운차니
기차다	기차	기차니
길다	길어	기니	기오
길다	길어	기니	기오
길둥글다	길둥글어	길둥그니	길둥그오
까다롭다	까다로워	까다로우니
까맣다	까매	까마니	까맣소
까지다	까지어(까져)	까지니
깡마르다	깡말라	깡마르니
깨닫다	깨달아	깨달으니	깨닫는
꺼멓다	꺼메	꺼머니	꺼멓소
꺽세다	꺽세어(꺽세)	꺽세니
껄끄럽다	껄끄러워	껄끄러우니
꼴사납다	꼴사나워	꼴사나우니
꾸미다	꾸미어(꾸며)	꾸미니
끈덕지다	끈덕지어(끈덕져)	끈덕지니
끈질기다	끈질기어(끈질겨)	끈질기니
나쁘다	나빠	나쁘니
나쁘다	나빠	나쁘니
나어리다	나어리어(나어려)	나어리니
날래다	날래어(날래)	날래니
날쌔다	날쌔어(날쌔)	날쌔니
날카롭다	날카로워	날카로우니
남다르다	남달라	남다르니
남모르다	남몰라	남모르니
남부끄럽다	남부끄러워	남부끄러우니
남부럽다	남부러워	남부러우니
낫다	나아	나으니
낫다	나아	나으니	낫는
낯간지럽다	낯간지러워	낯간지러우니
낯설다	낯설어	낯서니	낯서오
너그럽다	너그러워	너그러우니
너르다	널러	너르니
널따랗다	널따래	널따라니	널따랗소
네모나다	네모나	네모나니
네모지다	네모지어(네모져)	네모지니
노랗다	노래	노라니	노랗소
노르다	노르러	노르니
노엽다	노여워	노여우니
놀랍다	놀라워	놀라우니
높다	높아	높으니
높다랗다	높다래	높다라니	높다랗소
높푸르다	높푸르러	높푸르니
뇌꼴스럽다	뇌꼴스러워	뇌꼴스러우니
누렇다	누레	누러니	누렇소
누르다	눌러	누르니
누르다	누르러	누르니
누리다	누리어(누려)	누리니
누리다	누리어(누려)	누리니
눈꼴사납다	눈꼴사나워	눈꼴사나우니
눈물겹다	눈물겨워	눈물겨우니
눈부시다	눈부시어(눈부셔)	눈부시니
느껍다	느꺼워	느꺼우니
느리다	느리어(느려)	느리니
능갈치다	능갈치어(능갈쳐)	능갈치니
능글스럽다	능글스러워	능글스러우니
다되다	다되어(다돼)	다되니
다디달다	다디달아	다디다니	다디다오
다랍다	다라워	다라우니
다르다	달라	다르니
다부지다	다부지어(다부져)	다부지니
다사롭다	다사로워	다사로우니
다사롭다	다사로워	다사로우니
다습다	다스워	다스우니
다채롭다	다채로워	다채로우니
단조롭다	단조로워	단조로우니
달다	달아	다니	다오
달다	달아	다니	다오
달다	달아	다니	다오
달다	달아	다니	다오
달갑다	달가워	달가우니
닳아빠지다	닳아빠지어(닳아빠져)	닳아빠지니
당차다	당차	당차니
대수롭다	대수로워	대수로우니
대차다	대차	대차니
더디다	더디어(더뎌)	더디니
더럽다	더러워	더러우니
던적스럽다	던적스러워	던적스러우니
덜되다	덜되어(덜돼)	덜되니
덜떨어지다	덜떨어지어(덜떨어져)	덜떨어지니
덥다	더워	더우니
덩그렇다	덩그레	덩그러니	덩그렇소
덩이지다	덩이지어(덩이져)	덩이지니
뎅그렇다	뎅그레	뎅그러니	뎅그렇소
뎅그렇다	뎅그레	뎅그러니
도드라지다	도드라지어(도드라져)	도드라지니
도탑다	도타워	도타우니
동그랗다	동그래	동그라니	동그랗소
동떨어지다	동떨어지어(동떨어져)	동떨어지니
동뜨다	동떠	동뜨니
되다	되어(돼)	되니
되다	되어(돼)	되니
되다	되어(돼)	되니
되다	되어(돼)	되니
되디되다	되디되어(되디돼)	되디되니
되바라지다	되바라지어(되바라져)	되바라지니
되잖다	되잖아	되잖으니	되잖소
될성부르다	될성불러	될성부르니
두껍다	두꺼워	두꺼우니
두드러지다	두드러지어(두드러져)	두드러지니
두렵다	두려워	두려우니
두텁다	두터워	두터우니
둔덕지다	둔덕지어(둔덕져)	둔덕지니
둥그렇다	둥그레	둥그러니	둥그렇소
둥글다	둥글어	둥그니	둥그오
드물다	드물어	드무니	드무오
드세다	드세어(드세)	드세니
듣그럽다	듣그러워	듣그러우니
따갑다	따가워	따가우니
따사롭다	따사로워	따사로우니
따숩다	따수워	따수우니
따습다	따스워	따스우니
따시다	따시어(따셔)	따시니
똑같다	똑같아	똑같으니
똑바르다	똑발라	똑바르니
똥그랗다	똥그래	똥그라니	똥그랗소
뚱그렇다	뚱그레	뚱그러니	뚱그렇소
뛰어나다	뛰어나	뛰어나니
뜨겁다	뜨거워	뜨거우니
마렵다	마려워	마려우니
마르다	말라	마르니
마르다	말라	마르니
많다	많아	많으니	많소
말갛다	말개	말가니	말갛소
맛나다	맛나	맛나니
매끄럽다	매끄러워	매끄러우니
매몰차다	매몰차	매몰차니
매섭다	매서워	매서우니
매스껍다	매스꺼워	매스꺼우니
맵다	매워	매우니
맵디맵다	맵디매워	맵디매우니
맵짜다	맵짜	맵짜니
맵차다	맵차	맵차니
멀다	멀어	머니	머오
멀다	멀어	머니	머오
멀겋다	멀게	멀거니	멀겋소
멀겋다	멀게	멀거니	멀겋소
멀고멀다	멀고멀어	멀고머니
멋들어지다	멋들어지어(멋들어져)	멋들어지니
멋지다	멋지어(멋져)	멋지니
메마르다	메말라	메마르니
메스껍다	메스꺼워	메스꺼우니
모나다	모나	모나니
모르다	몰라	모르니
모지다	모지어(모져)	모지니
모지락스럽다	모지락스러워	모지락스러우니
모질다	모질어	모지니	모지오
목마르다	목말라	목마르니
못나다	못나
못되다	못되어(못돼)	못되니
못생기다	못생기어(못생겨)
몽글다	몽글어	몽그니	몽그오
무겁다	무거워	무거우니
무덥다	무더워	무더우니
무디다	무디어(무뎌)	무디니
무르다	물러	무르니
무르다	물러	무르니
무르다	물러	무르니
무섭다	무서워	무서우니
물리다	물리어(물려)	물리니
물리다	물리어(물려)	물리니
물리다	물리어(물려)	물리니
물리다	물리어	물려	물리니
물리다	물리어	물려	물리니
물매지다	물매지어(물매져)	물매지니
미끄럽다	미끄러워	미끄러우니
미덥다	미더워	미더우니
미욱스럽다	미욱스러워	미욱스러우니
믿음직스럽다	믿음직스러워	믿음직스러우니
밉다	미워	미우니
밉살스럽다	밉살스러워	밉살스러우니
바르다	발라	바르니
바르다	발라	바르니
바르다	발라	바르니
바르다	발라	바르니
바쁘다	바빠	바쁘니
반갑다	반가워	반가우니
발갛다	발개	발가니	발갛소
발칙스럽다	발칙스러워	발칙스러우니
밝다	밝아	밝으니	밝고	밝는	밝지
배고프다	배고파	배고프니
배다르다	배달라	배다르니
배부르다	배불러	배부르니
버겁다	버거워	버거우니
버성기다	버성기어(버성겨)	버성기니
벅차다	벅차	벅차니
번거롭다	번거로워	번거로우니
벌겋다	벌게	벌거니	벌겋소
별나다	별나	별나니
별다르다	별달라	별다르니
별스럽다	별스러워	별스러우니
볕바르다	볕발라	볕바르니
보드랍다	보드라워	보드라우니
보드랍다	보드라워	보드라와
보람차다	보람차	보람차니
보얗다	보얘	보야니	보얗소
복되다	복되어(복돼)	복되니
볼썽사납다	볼썽사나워	볼썽사나우니
부끄럽다	부끄러워	부끄러우니
부드럽다	부드러워	부드러우니
부럽다	부러워	부러우니
부르다	불러	부르니
부르다	불러	부르니
부시다	부시어(부셔)	부시니
부시다	부시어(부셔)	부시니
부시다	부시어(부셔)	부시니
부옇다	부예	부여니	부옇소
붉다	붉어	붉으니	붉고	붉지
비다	비어(벼)	비니
비리다	비리어(비려)	비리니
비싸다	비싸	비싸니
비탈지다	비탈지어(비탈져)	비탈지니
빠르다	빨라	빠르니
빡세다	빡세어(빡세)	빡세니
빨다	빨아	빠니	빠오
빨다	빨아	빠니	빠오
빨다	빨아	빠니	빠오
빨갛다	빨개	빨가니	빨갛소
빼나다	빼나	빼나니
빼어나다	빼어나	빼어나니
뻘겋다	뻘게	뻘거니	뻘겋소
뻣세다	뻣세어(뻣세)	뻣세니
뼈아프다	뼈아파	뼈아프니
뼈저리다	뼈저리어(뼈저려)	뼈저리니
뼈지다	뼈지어(뼈져)	뼈지니
뽀얗다	뽀얘	뽀야니	뽀얗소
뿌옇다	뿌예	뿌여니	뿌옇소
사납다	사나워	사나우니
살갑다	살가워	살가우니
살지다	살지어(살져)	살지니
살천스럽다	살천스러워	살천스러우니
삿되다	삿되어(삿돼)	삿되니
삿되다	삿되어(삿돼)	삿되니
상되다	상되어(상돼)	상되니
상스럽다	상스러워	상스러우니
새까맣다	새까매	새까마니	새까맣소
새되다	새되어(새돼)	새되니
새롭다	새로워	새로우니
새빨갛다	새빨개	새빨가니	새빨갛소
새삼스럽다	새삼스러워	새삼스러우니
새카맣다	새카매	새카마니	새카맣소
새파랗다	새파래	새파라니	새파랗소
새하얗다	새하얘	새하야니	새하얗소
색다르다	색달라	색다르니
색스럽다	색스러워	색스러우니	색스러운
샛노랗다	샛노래	샛노라니	샛노랗소
생급스럽다	생급스러워	생급스러우니
생기다	생기어(생겨)	생기니
서글프다	서글퍼	서글프니
서럽다	서러워	서러우니
서투르다	서툴러	서투르니
서툴다	서투니
섣부르다	섣불러	섣부르니
설다	설어	서니	서오
설다	설어	서니	서오
섧다	설워	설우니	섧고	섧지
성가시다	성가시어(성가셔)	성가시니
성글다	성글어	성그니	성그오
성기다	성기어(성겨)	성기니
성기다	성기어	성겨	성기니
성마르다	성말라	성마르니
성부르다	성불러	성부르니
성스럽다	성스러워	성스러우니
세다	세어(세)	세니
세다	세어(세)	세니
세다	세어(세)	세니
세모나다	세모나	세모나니
세모지다	세모지어(세모져)	세모지니
세차다	세차	세차니
속되다	속되어(속돼)	속되니
손쉽다	손쉬워	손쉬우니
수줍다	수줍어	수줍으니
숨가쁘다	숨가빠	숨가쁘니
숨차다	숨차	숨차니
숫되다	숫되어(숫돼)	숫되니
쉽다	쉬워	쉬우니
스스럽다	스스러워	스스러우니
슬프다	슬퍼	슬프니
슬프디슬프다	슬프디슬퍼	슬프디슬프니
시다	시어(셔)	시니
시건방지다	시건방지어(시건방져)	시건방지니
시꺼멓다	시꺼메	시꺼머니	시꺼멓소
시끄럽다	시끄러워	시끄러우니
시리다	시리어(시려)	시리니
시뻘겋다	시뻘게	시뻘거니	시뻘겋소
시커멓다	시커메	시커머니	시커멓소
시퍼렇다	시퍼레	시퍼러니	시퍼렇소
시푸르다	시푸르러	시푸르니
신비스럽다	신비스러워	신비스러우니
실답다	실다워	실다우니
싯누렇다	싯누레	싯누러니	싯누렇소
싱겁다	싱거워	싱거우니
싱그럽다	싱그러워	싱그러우니
싸다	싸	싸니
싸다	싸	싸니
싸다	싸	싸니
싸다	싸	싸니
싸다	싸	싸니
싸느랗다	싸느래	싸느라니	싸느랗소
쌍꺼풀지다	쌍꺼풀지어(쌍꺼풀져)	쌍꺼풀지니
쌍스럽다	쌍스러우니	쌍스러워
쌔다	쌔어	쌔니
쌔다	쌔어(쌔)	쌔니
쌔다	쌔어	쌔	쌔니
쑥스럽다	쑥스러워	쑥스러우니
쓰다	써	쓰니
쓰다	써	쓰니
쓰다	써	쓰니
쓰다	써	쓰니
쓰다	써	쓰니
쓰디쓰다	쓰디써	쓰디쓰니
쓰라리다	쓰라리어(쓰라려)	쓰라리니
쓰리다	쓰리어(쓰려)	쓰리니
아귀차다	아귀차	아귀차니
아깝다	아까워	아까우니
아니다	아니니	아니라
아니꼽다	아니꼬워	아니꼬우니
아롱지다	아롱지어(아롱져)	아롱지니
아름답다	아름다워	아름다우니
아름차다	아름차	아름차니
아리다	아리어(아려)	아리니
아리땁다	아리따워	아리따우니
아무렇다	아무래	아무러니	아무렇소
아쉽다	아쉬워	아쉬우니
아프다	아파	아프니
안되다	안되어(안돼)	안되니
안되다	안되어(안돼)	안되니
안쓰럽다	안쓰러워	안쓰러우니
안타깝다	안타까워	안타까우니
알맞다	알맞아	알맞으니
알차다	알차	알차니
암팡지다	암팡지어(암팡져)	암팡지니
앙칼지다	앙칼지어(앙칼져)	앙칼지니
애달프다	애달파	애달프니
애바르다	애발라	애바르니
애살스럽다	애살스러워	애살스러우니
애처롭다	애처로워	애처로우니
앳되다	앳되어(앳돼)	앳되니
야멸차다	야멸차	야멸차니
야무지다	야무지어(야무져)	야무지니
야물다	야물어	야무니	야무오
약빠르다	약빨라	약빠르니
약삭빠르다	약삭빨라	약삭빠르니
약아빠지다	약아빠지어(약아빠져)	약아빠지니
얄따랗다	얄따래	얄따라니	얄따랗소
얄밉다	얄미워	얄미우니
양지바르다	양지발라	양지바르니
어기차다	어기차	어기차니
어둡다	어두워	어두우니
어떻다	어때	어떠니	어떻소
어렵다	어려워	어려우니
어리다	어리어(어려)	어리니
어리다	어리어(어려)	어리니
어리다	어리어(어려)	어리니
어리석다	어리석어	어리석으니
어설프다	어설퍼	어설프니
어여쁘다	어여뻐	어여쁘니
어울리다	어울리어(어울려)	어울리니
어지럽다	어지러워	어지러우니
어질다	어질어	어지니	어지오
억세다	억세어(억세)	억세니
언덕지다	언덕지어(언덕져)	언덕지니
얼뜨다	얼떠	얼뜨니
엄청나다	엄청나	엄청나니
없다	없어	없으니	없고	없는	없지
여리다	여리어(여려)	여리니
여리디여리다	여리디여리어(여리디여려)	여리디여리니
여무지다	여무지어(여무져)	여무지니
역겹다	역겨워	역겨우니
연푸르다	연푸르러	연푸르니
예쁘다	예뻐	예쁘니
예쁘장스럽다	예쁘장스러워	예쁘장스러우니
예스럽다	예스러워	예스러우니
오래다	오래니
오래되다	오래되어(오래돼)	오래되니
오지다	오지어(오져)	오지니
오지다	오지어	오져	오지니
올바르다	올발라	올바르니
올차다	올차	올차니
옹골지다	옹골지어(옹골져)	옹골지니
옹골차다	옹골차	옹골차니
옹글다	옹글어	옹그니	옹그오
외롭다	외로워	외로우니
외지다	외지어(외져)	외지니
요렇다	요래	요러니	요렇소
우람차다	우람차	우람차니
우렁차다	우렁차	우렁차니
우세스럽다	우세스러워	우세스러우니
우스꽝스럽다	우스꽝스러워	우스꽝스러우니
우습다	우스워	우스우니
유다르다	유달라	유다르니
유별나다	유별나	유별나니
을씨년스럽다	을씨년스러워	을씨년스러우니
응달지다	응달지어(응달져)	응달지니
의롭다	의로워	의로우니
이다	이어(여)	이니
이다	이어(여)	이니
이러다	이래	이러니
이렇다	이래	이러니	이렇소
이롭다	이로워	이로우니
이르다	이르러	이르니
이르다	일러	이르니
이르다	일러	이르니
이쁘다	이뻐	이쁘니
이채롭다	이채로워	이채로우니
일매지다	일매지어(일매져)	일매지니
입빠르다	입빨라	입빠르니
잇다	이어	이으니	잇는
잇다	이어	이으니	잇는
잇다	이어	이으니
있다	있어	있으니	있는
자그맣다	자그매	자그마니	자그맣소
자깝스럽다	자깝스러워	자깝스러우니
자디잘다	자디잘아	자디자니	자디자오
자애롭다	자애로워	자애로우니
자유롭다	자유로워	자유로우니
작다	작아	작으니
작다랗다	작다래	작다라니	작다랗소
잗다랗다	잗다래	잗다라니	잗다랗소
잘다	잘아	자니	자오
잘나다	잘나
잘빠지다	잘빠지어(잘빠져)	잘빠지니
잘생기다	잘생기어(잘생겨)
잡되다	잡되어(잡돼)	잡되니
잡스럽다	잡스러워	잡스러우니
재다	재어(재)	재니
재다	재어(재)	재니
재다	재어(재)	재니
재다	재어(재)	재니
재다	재어(재)	재니
재미나다	재미나	재미나니
재밌다	재밌어	재밌으니	재밌는
재빠르다	재빨라	재빠르니
잽싸다	잽싸	잽싸니
저렇다	저래	저러니	저렇소
저리다	저리어(저려)	저리니
점잖다	점잖아	점잖으니	점잖소
정겹다	정겨워	정겨우니
정답다	정다워	정다우니
조그맣다	조그매	조그마니	조그맣소
졸리다	졸리어(졸려)	졸리니
졸리다	졸리어(졸려)	졸리니
졸리다	졸리어(졸려)	졸리니
좀스럽다	좀스러워	좀스러우니
좁다	좁아	좁으니
좁다랗다	좁다래	좁다라니	좁다랗소
좁아터지다	좁아터지어(좁아터져)	좁아터지니
종요롭다	종요로워	종요로우니
좋다	좋아	좋으니	좋소
줄기차다	줄기차	줄기차니
중뿔나다	중뿔나	중뿔나니
즐겁다	즐거워	즐거우니
지다	지어(져)	지니
지다	지어(져)	지니
지다	지어(져)	지니
지다	지어(져)	지니
지겹다	지겨워	지겨우니
지나치다	지나치어(지나쳐)	지나치니
지리다	지리어(지려)	지리니
지리다	지리어(지려)	지리니
지리다	지리어(지려)	지리니
질다	질어	지니	지오
질기다	질기어(질겨)	질기니
징그럽다	징그러워	징그러우니
짙푸르다	짙푸르러	짙푸르니
짜다	짜	짜니
짜다	짜	짜니
짜다	짜	짜니
짜디짜다	짜디짜니	짜디짜
쪼그맣다	쪼그매	쪼그마니	쪼그맣소
쪼끄맣다	쪼끄매	쪼끄마니	쪼끄맣소
차다	차	차니
차다	차	차니
차다	차	차니
차다	차	차니
차갑다	차가워	차가우니
차디차다	차디차	차디차니
차지다	차지어(차져)	차지니
찰지다	찰지어(찰져)	찰지니
참되다	참되어(참돼)	참되니
천연덕스럽다	천연덕스러워	천연덕스러우니
철겹다	철겨워	철겨우니
촌스럽다	촌스러워	촌스러우니
춥다	추워	추우니
치우다	치우어(치워)	치우니
커다랗다	커다래	커다라니	커다랗소
커닿다	커대	커다니	커닿소
크다	커	크니
크나크다	크나커	크나크니
큰일나다	큰일나	큰일나니
탐스럽다	탐스러워	탐스러우니
투박스럽다	투박스러워	투박스러우니
특별나다	특별나	특별나니
특출나다	특출나	특출나니
특출나다	특출나	특출나니
틀리다	틀리어(틀려)	틀리니
틀리다	틀리어(틀려)	틀리니
파랗다	파래	파라니	파랗소
패다	패어	패니
패다	패어(패)	패니
패다	패어(패)	패니
패다	패어(패)	패니
패다	패어(패)	패니
퍼렇다	퍼레	퍼러니	퍼렇소
편찮다	편찮아	편찮으니	편찮소
푸르다	푸르러	푸르니
푸르디푸르다	푸르디푸르러	푸르디푸르니
푸르르다	푸르러	푸르르니
푸르르다	푸르러	푸르르니
푸지다	푸지어(푸져)	푸지니
하다	하여(해)	하니
하얗다	하얘	하야니	하얗소
한갓지다	한갓지어(한갓져)	한갓지니
해롭다	해로워	해로우니
해말갛다	해말개	해말가니	해말갛소
허여멀겋다	허여멀게	허여멀거니	허여멀겋소
허옇다	허예	허여니	허옇소
헌걸차다	헌걸차	헌걸차니
헐겁다	헐거워	헐거우니
헛되다	헛되어(헛돼)	헛되니
헤벌어지다	헤벌어지어(헤벌어져)	헤벌어지니
헤프다	헤퍼	헤프니
호되다	호되어(호돼)	호되니
활기차다	활기차	활기차니
후덥다	후더워	후더우니
후미지다	후미지어(후미져)	후미지니
후지다	후지어(후져)	후지니
휘둥그렇다	휘둥그레	휘둥그러니	휘둥그렇소
흐드러지다	흐드러지어(흐드러져)	흐드러지니
흐리다	흐리어(흐려)	흐리니
흐리다	흐리어(흐려)	흐리니
흐리다	흐리어	흐려	흐리니
흐리다	흐리어	흐려	흐리니
흐무러지다	흐무러지어(흐무러져)	흐무러지니
흐벅지다	흐벅지어(흐벅져)	흐벅지니
흥겹다	흥겨워	흥겨우니
흥미롭다	흥미로워	흥미로우니
희다	희어	희니
희디희다	희디희어	희디희니
희떱다	희떠워	희떠우니
희망차다	희망차	희망차니
희멀겋다	희멀게	희멀거니	희멀겋소
희부옇다	희부예	희부여니	희부옇소
희뿌옇다	희뿌예	희뿌여니	희뿌옇소
힘겹다	힘겨워	힘겨우니
힘들다	힘들어	힘드니	힘드오
힘세다	힘세어(힘세)	힘세니
힘차다	힘차	힘차니